Afrodite	Ancient Greek
Alexandra	Ancient Greek
analytisk	Ancient Greek
Aphrodite	Ancient Greek
Apollon	Ancient Greek
Athen	Ancient Greek
Athena	Ancient Greek
Athene	Ancient Greek
athenæer	Ancient Greek
attisk	Ancient Greek
Cypern	Ancient Greek
Dionysos	Ancient Greek
episk	Ancient Greek
Europa	Ancient Greek
europæer	Ancient Greek
europæisk	Ancient Greek
harmoni	Ancient Greek
Hera	Ancient Greek
heureka	Ancient Greek
Hypnos	Ancient Greek
keramik	Ancient Greek
komedie	Ancient Greek
komisk	Ancient Greek
kyklop	Ancient Greek
mytisk	Ancient Greek
Pandora	Ancient Greek
Paris	Ancient Greek
Persefone	Ancient Greek
Platon	Ancient Greek
tragedie	Ancient Greek
trapez	Ancient Greek
ypsilon	Ancient Greek
Zeus	Ancient Greek
falafel	Arabic
fatwa	Arabic
halal	Arabic
inshallah	Arabic
muslim	Arabic
Rabat	Arabic
sharia	Arabic
sura	Arabic
wallah	Arabic
Amsterdam	Dutch
blomkål	Dutch
ebbe	Dutch
flag	Dutch
gylp	Dutch
Holland	Dutch
ikke en døjt	Dutch
krejert	Dutch
matros	Dutch
smølf	Dutch
sprøjte	Dutch
stovt	Dutch
togt	Dutch
val	Dutch
vaterpas	Dutch
abstrakt	English
Alabama	English
Alaska	English
album	English
Alfred	English
algoritme	English
Alice	English
anyway	English
app	English
Arizona	English
Arkansas	English
Arthur	English
baby	English
babymassage	English
babysitter	English
babysitting	English
bachelor	English
badminton	English
bar	English
basketball	English
bat	English
betablokker	English
Big Bang	English
Big Data	English
Big Mac	English
big time	English
bitter	English
blender	English
blog	English
blowjob	English
blues	English
bluf	English
bluff	English
bodybuilder	English
bodybuilding	English
boomerang	English
bowle	English
bowling	English
boykot	English
brand	English
brandy	English
Brian	English
bridge	English
browser	English
brunch	English
brunche	English
buffer	English
bulldozer	English
bullet	English
burger	English
bævernylon	English
cache	English
Californien	English
californium	English
camper	English
camping	English
candyfloss	English
cd	English
cellofan	English
charm	English
check	English
cheerleader	English
chips	English
clean	English
collateral damage	English
collie	English
Colorado	English
computer	English
Connecticut	English
Connie	English
controller	English
crowdfunding	English
cute	English
cyklon	English
database	English
deepthroate	English
Delaware	English
dickpic	English
dildo	English
disse	English
dollar	English
dopamin	English
downloade	English
dram	English
drink	English
eagle	English
Edith	English
Edvin	English
Ellinor	English
Elmer	English
establishment	English
event	English
Facebook	English
fake news	English
fancy	English
Fanny	English
fantasy	English
fashionabel	English
feedback	English
fil	English
finish	English
fjæs	English
flag	English
flange	English
flannel	English
Florida	English
folk	English
folklore	English
Freddy	English
fuck	English
fuckfinger	English
fucking	English
fundamentalisme	English
gamer	English
gangbange	English
gated community	English
gaydar	English
Georgia	English
golden retriever	English
graf	English
grapefrugt	English
green	English
gubbi	English
gå all in	English
hacke	English
hacker	English
hall	English
harddisk	English
harmonika	English
Harry	English
hash	English
hashtag	English
Hawaii	English
hint	English
hit	English
hobby	English
hotdog	English
HP	English
hyperlink	English
Idaho	English
Illinois	English
incel	English
Indiana	English
innovativ	English
intercitytog	English
internet	English
Iowa	English
iPhone	English
jazz	English
Jersey	English
Jessica	English
Jim	English
job	English
joke	English
joker	English
juice	English
jungle	English
Kansas	English
Kentucky	English
ketchup	English
Kevin	English
keynesianisme	English
kiks	English
KISS	English
koala	English
krank	English
kvark	English
kænguru	English
largeness	English
Liam	English
libertarianisme	English
lift	English
like	English
Lillian	English
lime	English
link	English
live	English
lokomotiv	English
LOL	English
lolita	English
Louisiana	English
mafia	English
mail	English
Maine	English
malware	English
Maryland	English
Massachusetts	English
medley	English
melatonin	English
messe	English
Michigan	English
Mickey Mouse	English
Mike	English
Minnesota	English
misse	English
missil	English
Mississippi	English
Missouri	English
mobbe	English
mobning	English
Montana	English
motherboard	English
mountainbike	English
muffin	English
musical	English
musikvideo	English
Nanny	English
Nebraska	English
Nelly	English
Nevada	English
never mind	English
New Hampshire	English
New Jersey	English
New Mexico	English
New York	English
nigger	English
no go	English
no homo	English
no offense	English
no problemo	English
nonsens	English
North Carolina	English
North Dakota	English
nutria	English
nørd	English
Ohio	English
Oklahoma	English
Oliver	English
opdatere	English
Oregon	English
Oskar	English
Osvald	English
outsourcing	English
over	English
paddel	English
palaver	English
par	English
partner	English
password	English
peanut	English
peanutbutter	English
Pennsylvania	English
pingpong	English
plastic	English
powerpoint	English
proaktiv	English
producer	English
propeller	English
putte	English
pyjamas	English
quarterback	English
queer	English
quiz	English
race	English
racer	English
rad	English
reel	English
Rhode Island	English
rig	English
rimming	English
Robin	English
Ronnie	English
roomie	English
safe word	English
sandwich	English
sandwichmand	English
score	English
scrolle	English
selfie	English
shampoo	English
show	English
slang	English
slowmotion	English
smalltalk	English
smart	English
smiley	English
South Carolina	English
South Dakota	English
spam	English
sponsor	English
spot	English
spotte	English
start	English
starte	English
statussymbol	English
strejke	English
stress	English
stresse	English
super	English
tabu	English
tag	English
tank	English
teenager	English
Tennessee	English
tennessin	English
tennis	English
terrier	English
test	English
teste	English
Texas	English
the shit	English
tight	English
time	English
timer	English
tjek	English
tjekke	English
tl;dr	English
Tom	English
traktor	English
trekke	English
trick	English
træne	English
turkish delight	English
tweet	English
tweete	English
uploade	English
Utah	English
Vermont	English
video	English
Virginia	English
walkie-talkie	English
Washington	English
website	English
weekend	English
West Virginia	English
whist	English
whistleblower	English
wiki	English
Wikipedia	English
Wiktionary	English
William	English
Wisconsin	English
Wyoming	English
yes	English
yo	English
you name it	English
ablativ	French
abonnement	French
absence	French
adjø	French
adresse	French
ah	French
ajour	French
akkolade	French
akkord	French
akkordeon	French
albumin	French
alfons	French
allé	French
amatør	French
ambassade	French
ambulance	French
ananas	French
anciennitet	French
Annette	French
appetit	French
apropos	French
arbitrær	French
arrangement	French
artificiel	French
assemblage	French
assortiment	French
aubergine	French
automobil	French
avancere	French
avantgarde	French
avenue	French
avis	French
bagage	French
bagatel	French
bajonet	French
balkon	French
ballade	French
ballon	French
baluster	French
banan	French
bandage	French
bank	French
barok	French
barre	French
barrikade	French
base	French
bassin	French
batteri	French
beton	French
bibliotek	French
billard	French
billet	French
binær	French
bistro	French
bivuak	French
bizar	French
boheme	French
bombardement	French
bombe	French
bordel	French
boulevard	French
bouquet	French
branche	French
breche	French
brillant	French
brochure	French
brom	French
bronze	French
brunette	French
Bruxelles	French
budget	French
buket	French
bureau	French
bureaukrat	French
buste	French
butik	French
c'est la vie	French
cadeau	French
café	French
café au lait	French
cerebral	French
ceremoni	French
chaiselong	French
champignon	French
chance	French
changere	French
charabanc	French
Charlotte	French
charme	French
charmere	French
chateau	French
chauffør	French
chef	French
chikane	French
chimpanse	French
chok	French
cigaret	French
citron	French
cognac	French
creme	French
creme de la creme	French
cremefraiche	French
daguerreotypi	French
dam	French
dame	French
dans	French
debat	French
debut	French
defaitisme	French
delikat	French
demokrati	French
demokratisk	French
demonstrativ	French
departement	French
depeche	French
deplacement	French
depot	French
deroute	French
desarmere	French
desertør	French
dessert	French
detachement	French
detalje	French
detente	French
devaluere	French
diplom	French
diplomat	French
direktør	French
diskotek	French
disput	French
distance	French
dragé	French
droge	French
dusin	French
egal	French
egalitær	French
eksistentialisme	French
eksperimentere	French
ekspertise	French
ekstrem	French
ekvipage	French
elegant	French
elementær	French
elev	French
emigrere	French
en passant	French
enorm	French
ensilage	French
entrecote	French
entré	French
eskadrille	French
esplanade	French
estragon	French
etage	French
etape	French
etikette	French
fabrik	French
facet	French
facon	French
fagot	French
fars	French
favorisere	French
favorit	French
feminisme	French
femme fatale	French
filet	French
filigran	French
financier	French
finans	French
flakon	French
flamboyant	French
flankere	French
flanør	French
fontæne	French
force majeure	French
franc	French
fregat	French
frikassé	French
fripon	French
frise	French
friture	French
front	French
fuga	French
galleri	French
galoche	French
galop	French
gamache	French
garage	French
garde	French
gele	French
gelé	French
genre	French
gepard	French
gnom	French
grimasse	French
guirlande	French
guvernør	French
hangar	French
Henriette	French
honnør	French
honorær	French
hotel	French
humør	French
ignorere	French
illusion	French
imaginær	French
imposant	French
industri	French
ingeniør	French
interessant	French
jalousi	French
jaloux	French
jasmin	French
jeton	French
jonglør	French
kanalisere	French
kanalje	French
kanapé	French
kanonisere	French
karaffel	French
karakterisere	French
karamel	French
karantæne	French
kaskade	French
kasket	French
kasserolle	French
kavaleri	French
kaviar	French
kokon	French
kombattant	French
komfur	French
kommandør	French
kommode	French
kommunal	French
kommune	French
kompagnon	French
kompliment	French
kompost	French
kompot	French
kompromis	French
komtesse	French
konfiture	French
konservativ	French
konsol	French
kontrol	French
konvoj	French
korps	French
korset	French
korvet	French
kriminel	French
kulør	French
kup	French
kupon	French
kurage	French
kurer	French
kuriøs	French
kusine	French
kutyme	French
kærtegne	French
kø	French
Laurine	French
lekture	French
litterær	French
lokale	French
lokalisere	French
loyal	French
lukrativ	French
luksuriøs	French
løjtnant	French
magasin	French
maksime	French
mannequin	French
march	French
marchere	French
Margot	French
Marion	French
markis	French
markise	French
marmelade	French
massakre	French
massakrere	French
massør	French
massøse	French
materiel	French
mayonnaise	French
medalje	French
medaljon	French
melodiøs	French
menage	French
menage a trois	French
menu	French
metier	French
Michelle	French
migræne	French
militær	French
miljø	French
milliard	French
million	French
mode	French
mole	French
molestere	French
monetær	French
montage	French
moræne	French
moské	French
motion	French
motiv	French
motivation	French
musket	French
musketer	French
møbel	French
nervøs	French
nevø	French
nikotin	French
niveau	French
nomade	French
nonchalant	French
novelle	French
observatør	French
odør	French
offensiv	French
omelet	French
onkel	French
ordonnans	French
ordre	French
organisme	French
ouverture	French
palet	French
palisade	French
palæ	French
panere	French
paraply	French
parcel	French
parfume	French
parfumere	French
parti	French
paryk	French
pas	French
passabel	French
passager	French
pate	French
paté	French
pauver	French
pavillon	French
pendant	French
penibel	French
perfid	French
persienne	French
perspektiv	French
petit mal	French
pingvin	French
pittoresk	French
pjece	French
planche	French
plateau	French
point	French
pointe	French
pomfrit	French
pomme frite	French
populær	French
porcelæn	French
portefølje	French
portemonnæ	French
post	French
primitiv	French
princip	French
produktiv	French
proper	French
rabat	French
race	French
raffinere	French
ragout	French
rang	French
rapport	French
razzia	French
realisere	French
realist	French
reciprok	French
redaktør	French
reel	French
refræn	French
regissør	French
relief	French
religiøs	French
remoulade	French
rendezvous	French
rentabel	French
reportage	French
republik	French
ressource	French
rest	French
restaurant	French
resultat	French
resume	French
resurse	French
revanche	French
revy	French
risalamande	French
rokade	French
rokere	French
rosé	French
roulade	French
ræson	French
ræsonnere	French
sabotage	French
sadisme	French
salut	French
sanitær	French
seksuel	French
sidste skrig	French
sinecure	French
smoking	French
social	French
socialist	French
sonde	French
sort	French
sovs	French
sterilisere	French
succes	French
suveræn	French
taburet	French
talje	French
tante	French
teint	French
teokrati	French
terrasse	French
territorial	French
terræn	French
toilet	French
trist	French
trubadur	French
træf	French
træn	French
tur	French
unik	French
vasal	French
vase	French
vinaigrette	French
vis-a-vis	French
vulgær	French
à la	French
afdeling	German
anbefale	German
anerkende	German
anføre	German
ankomst	German
anse	German
antistof	German
apparat	German
arbejde	German
arbejdsløs	German
arte	German
Athen	German
athener	German
athenienser	German
atheniensisk	German
athensk	German
athenæer	German
athenæisk	German
attisk	German
bakkenbarter	German
bambus	German
bande	German
bengel	German
berg	German
besserwisser	German
bibringe	German
bilde	German
billig	German
billige	German
binde an	German
blitz	German
blokfløjte	German
bremse	German
brille	German
bøffel	German
bøs	German
charmant	German
chokolade	German
cobalt	German
das	German
DDR	German
disse	German
dufte	German
dur	German
dus	German
ebbe	German
egenart	German
egenhændig	German
Elben	German
elfenben	German
episk	German
erfare	German
erkende	German
europæer	German
europæisk	German
fabrik	German
familie	German
fej	German
fejre	German
fest	German
fif	German
flamme	German
flonel	German
flor	German
forehavende	German
forhåbentlig	German
forlag	German
forskertse	German
fortfarende	German
frakke	German
Frans	German
franskmand	German
frikadelle	German
frosch	German
fukssvans	German
fuldstændig	German
gast	German
gebrokken	German
gehejm	German
gejst	German
gejstlig	German
gelænder	German
giraf	German
gletsjer	German
gruppe	German
Gunda	German
hang	German
Hans	German
Hartmann	German
heks	German
hektisk	German
herkomst	German
Hertha	German
Homer	German
homoseksuel	German
husgeråd	German
hytte	German
håndgemæng	German
hækle	German
interessere	German
Interlaken	German
Italien	German
italiener	German
italiensk	German
juvel	German
kakkel	German
kant	German
kappe	German
kaput	German
kartoffel	German
kel	German
kere	German
klassiker	German
klassisk	German
klods	German
knejpe	German
kok	German
komedie	German
komisk	German
kort	German
kradse	German
kujon	German
kvark	German
kvarter	German
kvarts	German
lak	German
liderlig	German
Liselotte	German
liste	German
ludder	German
lærk	German
m/	German
Marlene	German
martre	German
mejeri	German
mejsel	German
melis	German
mislykkes	German
mol	German
muffe	German
myriade	German
nar	German
nedertysk	German
net	German
nøgtern	German
Oda	German
offentlig	German
onkel	German
ordentlig	German
orgel	German
Otto	German
paprika	German
pas	German
pauke	German
Peloponnes	German
Polen	German
politik	German
politiker	German
politisk	German
polterabend	German
pragt	German
presse	German
prins	German
procent	German
prægtig	German
rabat	German
radbrække	German
rage	German
regelmæssig	German
rejse	German
Rothschild	German
runde	German
rygrad	German
Sachsen	German
saft	German
salonfähig	German
scheisse	German
Schwarzwälder Kirschtorte	German
se an	German
seddel	German
sigt	German
sigte	German
sigøjner	German
sjofel	German
skaffe	German
skalte	German
skridt	German
skue	German
sky	German
skærtse	German
slagter	German
slave	German
slavisk	German
slugt	German
sløjfe	German
snaps	German
socialdemokrat	German
socialdemokrati	German
spalte	German
spatel	German
specialisere	German
staffeli	German
stilleben	German
stof	German
stræbe	German
svækling	German
syndflod	German
sålbænk	German
søjle	German
tante	German
tast	German
tastatur	German
Themsen	German
tjekke	German
tragedie	German
tragisk	German
trapez	German
trist	German
trit	German
trods	German
træf	German
træffe	German
trøffel	German
ungefähr	German
ungefær	German
uvæsen	German
valte	German
vampyr	German
vat	German
velberåd	German
verfe	German
virkelig	German
vits	German
vrage	German
væsen	German
væsentlig	German
Wolfgang	German
zirkon	German
ærgerlig	German
ætse	German
a cappella	Italian
a conto	Italian
akvarel	Italian
arie	Italian
arkitrav	Italian
bankerot	Italian
Bianca	Italian
caffelatte	Italian
fallit	Italian
fatamorgana	Italian
forte	Italian
fuga	Italian
Genova	Italian
grave	Italian
konto	Italian
mandola	Italian
Napoli	Italian
patina	Italian
pizza	Italian
soda	Italian
sonate	Italian
sonet	Italian
tempo	Italian
tulipan	Italian
valuta	Italian
aikido	Japanese
anime	Japanese
bonsai	Japanese
harakiri	Japanese
judo	Japanese
karate	Japanese
kimono	Japanese
manga	Japanese
ninja	Japanese
seppuku	Japanese
shogun	Japanese
sudoku	Japanese
sushi	Japanese
tsunami	Japanese
absurd	Latin
addere	Latin
adjunkt	Latin
advent	Latin
agere	Latin
agil	Latin
aktie	Latin
aktiv	Latin
Alper	Latin
Alperne	Latin
apologetisk	Latin
Aristoteles	Latin
Athen	Latin
athenienser	Latin
atheniensisk	Latin
attisk	Latin
auditorium	Latin
august	Latin
autoritet	Latin
basis	Latin
blide	Latin
Britannien	Latin
cancer	Latin
central	Latin
Cicero	Latin
cirkel	Latin
citer	Latin
civil	Latin
conditio humana	Latin
dativ	Latin
debil	Latin
debitor	Latin
dekret	Latin
desperation	Latin
discipel	Latin
distrahere	Latin
ekspansion	Latin
eksponere	Latin
ekstrahere	Latin
elefant	Latin
episk	Latin
erektion	Latin
et tu, Brute	Latin
Europa	Latin
europæer	Latin
europæisk	Latin
fabrik	Latin
familie	Latin
fiksere	Latin
form	Latin
funktion	Latin
føniks	Latin
gemme	Latin
glans	Latin
humor	Latin
humør	Latin
id	Latin
ignorant	Latin
ignorere	Latin
imperium	Latin
impuls	Latin
information	Latin
ingrediens	Latin
inkorporere	Latin
institution	Latin
Italien	Latin
jura	Latin
kamin	Latin
kandidat	Latin
kapitel	Latin
kapitæl	Latin
klassiker	Latin
klassisk	Latin
komedie	Latin
komisk	Latin
kompleks	Latin
konditor	Latin
labil	Latin
legal	Latin
lektor	Latin
maj	Latin
Majestæt	Latin
Maria	Latin
marin	Latin
Markus	Latin
medie	Latin
memento mori	Latin
minister	Latin
minut	Latin
monument	Latin
mor	Latin
museum	Latin
mæcen	Latin
ne bis in idem	Latin
neutrum	Latin
nominal	Latin
olie	Latin
origo	Latin
parat	Latin
passiv	Latin
Paula	Latin
Paulus	Latin
penis	Latin
pensum	Latin
pression	Latin
privilegium	Latin
prosit	Latin
pulver	Latin
Pyrenæerne	Latin
radius	Latin
raritet	Latin
recessiv	Latin
region	Latin
rekonvalescent	Latin
resonere	Latin
rotere	Latin
student	Latin
sulfur	Latin
supplere	Latin
symbol	Latin
taks	Latin
tangens	Latin
testimonium	Latin
tragedie	Latin
tragisk	Latin
trapez	Latin
ultra-	Latin
vagina	Latin
veteran	Latin
via	Latin
vice versa	Latin
virus	Latin
visum	Latin
zenit	Latin