αμπάριζα	Albanian
αρβανός	Albanian
βαΐζω	Albanian
βλάμης	Albanian
Γουρημάδι	Albanian
γούβα	Albanian
καλαμπόκι	Albanian
μπέσα	Albanian
μπαμπέσης	Albanian
μπομπότα	Albanian
πλιάτσικο	Albanian
Πρέβεζα	Albanian
σβέρκος	Albanian
Αλλάχ	Arabic
γινάτι	Arabic
ινάτι	Arabic
καντάρι	Arabic
κουσούρι	Arabic
λαγούμι	Arabic
λουκουμάς	Arabic
λουκούμι	Arabic
μιναρές	Arabic
μπαγιάτικος	Arabic
μπακάλης	Arabic
μπατανία	Arabic
μπελάς	Arabic
μπινές	Arabic
μπουρνούζι	Arabic
Μωάμεθ	Arabic
νταβατζής	Arabic
Ορμούζ	Arabic
Ραμαζάνι	Arabic
ρεζίλι	Arabic
ρουσφέτι	Arabic
σαγάνι	Arabic
σαγανάκι	Arabic
σακάτης	Arabic
σουλτάνος	Arabic
ταμπάκης	Arabic
τεμενάς	Arabic
τεφτέρι	Arabic
τζερτζελές	Arabic
τσαμπουκάς	Arabic
φέσι	Arabic
χάπι	Arabic
χαζός	Arabic
χαλίφης	Arabic
χαμάμ	Arabic
χαμπάρι	Arabic
χαμπέρι	Arabic
χαράμι	Arabic
Αβετισιάν	Armenian
Αγατζανιάν	Armenian
Αλεξανιάν	Armenian
Αντρεασιάν	Armenian
Αρσακιάν	Armenian
Γαζαριάν	Armenian
Γκαζαριάν	Armenian
Καμπουτιάν	Armenian
μαζούν	Armenian
μακάρτι	Armenian
Μελικιάν	Armenian
Ναρινιάν	Armenian
Ντεμιρτσιάν	Armenian
άνορακ	English
άουτ	English
Άρκανσας	English
Έβαν	English
Έιμι	English
Έιντζελ	English
Έντι	English
Έντουαρντ	English
Έρικ	English
Ίαν	English
ίντερνετ	English
Αβάνα	English
αγιατολάχ	English
αιρκοντίσιον	English
Αλάσκα	English
Αλαμπάμα	English
Ανγκουίλα	English
ανθέμιο	English
Αντίγκουα	English
αντεργκράουντ	English
αουτσάιντερ	English
απαρτχάιντ	English
Αριζόνα	English
Αυστραλία	English
Αϊντάχο	English
Αϊόβα	English
βίντεο	English
βαθμός Κέλβιν	English
βαν	English
Βερόνικα	English
βεσέ	English
Βινς	English
Βιρτζίνια	English
Γέλοουναϊφ	English
γαλόνι	English
γιοτ	English
γιοττα-	English
Γιόντα	English
Γκάνα	English
Γκάρφιλντ	English
γκέι	English
Γκιμπς	English
Γκούντμαν	English
γκρέιπφρουτ	English
Γκρέις	English
Γκραντ	English
Γκρεγκ	English
Γκριν	English
γκρουμ	English
Γκόρντον	English
γλωσσολαλιά	English
Γουόκερ	English
Γουόλτερ	English
δεινόσαυρος	English
Δελχί	English
ελληνιστικός	English
εξα-	English
ζεττα-	English
θρίλερ	English
ιαγουάρος	English
Ιλινόις	English
Ιντιάνα	English
ιστόγραμμα	English
Κάθριν	English
Κάνσας	English
Κάρεν	English
Κάρτερ	English
Κέβιν	English
κέικ	English
κέικς	English
Κέισι	English
Κέιτ	English
Κέιτι	English
Κέλβιν	English
Κέλι	English
Κένεντι	English
κίνα	English
κακατούα	English
Καλιφόρνια	English
καμικάζι	English
Καμπέρα	English
καουμπόι	English
κβάντο	English
Κεντάκι	English
Κιθ	English
κιλο-	English
κιλοβατώρα	English
Κινγκ	English
κλινική	English
κλόουν	English
κοκτέιλ	English
κολέγιο	English
Κολοράντο	English
Κονέκτικατ	English
κορνφλάουρ	English
κουάρκ	English
κουκαμπούρα	English
κουλροφοβία	English
κρίπερ	English
Κρίστιαν	English
Κριστίνα	English
κρυοπάγημα	English
Κόλιν	English
Κόλινς	English
Κόνλεϋ	English
λάμα	English
Λάνα	English
Λέοναρντ	English
Λίμερικ	English
Λίνκολν	English
Λίο	English
λαίδη	English
Ληντς	English
λοκ άουτ	English
Λουιζιάνα	English
Λουκ	English
λούνα παρκ	English
μάγια	English
Μάθιου	English
Μάικλ	English
μάνατζερ	English
μάνατζμεντ	English
μάρκετινγκ	English
Μάρτιν	English
Μέιν	English
μέινστριμ	English
Μέρεντιθ	English
Μέριλαντ	English
Μίλερ	English
Μίσιγκαν	English
Μίτσελ	English
Μαίρη	English
Μαλάουι	English
Μασαχουσέτη	English
ματζέντα	English
ματς	English
Μελβούρνη	English
μελόντικα	English
Μιζούρι	English
Μινεσότα	English
Μισέλ	English
Μισισίπι	English
Μοντάνα	English
μπάρμπεκιου	English
μπαμπού	English
μπαργούμαν	English
μπλάκης	English
μπλάντι	English
Μπομπ	English
Μπράιαν	English
Μπράντον	English
Μπράουν	English
Μπόμπι	English
μπόντι μπίλντερ	English
Μόργκαν	English
Νέα Ζηλανδία	English
Νέιθαν	English
νέον	English
Νίκολς	English
ΝΑΤΟ	English
Νεβάδα	English
Νεμπράσκα	English
Ντάνιελ	English
Ντέιβ	English
Ντέιβιντ	English
Ντέιβις	English
Ντέλαγουερ	English
Ντένις	English
Ντέξτερ	English
Ντέρεκ	English
ντελίβερι	English
ντελιβεράς	English
ντεντέκτιβ	English
ντετέκτιβ	English
Νόργουιτς	English
ξενοφοβία	English
Οκλαχόμα	English
Ολύμπια	English
Οσάκα	English
ουάου	English
ουτοπία	English
Οφηλία	English
οφσάιντ	English
ούφο	English
Πάιπερ	English
Πάλμερ	English
πάλσαρ	English
πάνελ	English
πάρκινγκ	English
πάρκινσον	English
Πάτρικ	English
Πέιτζ	English
Πέρσι	English
παζλ	English
πιγκ πογκ	English
πικάπ	English
πιόνιο	English
πουλόβερ	English
Πωλ	English
Ράιαν	English
Ράσελ	English
Ρέιτσελ	English
Ρίτσαρντ	English
Ρεμπέκα	English
ρεπόρτερ	English
Ροβέρτος	English
ρομαντικός	English
Ρομπέν	English
Ρόι	English
ρόλεϊ	English
Ρόμπερτ	English
Ρότζερ	English
Σάιμον	English
Σάλι	English
σάντουιτς	English
Σάρλοτ	English
σέλφι	English
σέντερ	English
σέντερ μπακ	English
σέντερ φορ	English
σέξι	English
Σέπαρντ	English
Σέφιλντ	English
σίριαλ	English
σίριαλ κίλερ	English
σαγιονάρα	English
Σεβίλλη	English
Σεθ	English
σερ	English
Σιέρα Λεόνε	English
σκάνερ	English
σκέιτ	English
σκέιτμπορντ	English
σκέιτμπορντινγκ	English
σκορ	English
Σκοτ	English
Σμιθ	English
Σον	English
σουλφίδιο	English
σουπερμάρκετ	English
σουτ	English
Σούζαν	English
σπριντ	English
Στίβεν	English
Σταν	English
Στιβ	English
στοπ	English
σόου	English
Τάιλερ	English
τάπερ	English
Τέιλορ	English
τένις	English
Τέξας	English
τερπένιο	English
τεστ	English
Τζάκσον	English
Τζέικ	English
Τζέικομπ	English
Τζέιμι	English
Τζέιμς	English
Τζέιν	English
Τζέισον	English
Τζένιφερ	English
Τζίμι	English
τζίντζερ	English
τζαζ	English
Τζακ	English
Τζεφ	English
Τζιμ	English
τζιν	English
Τζιν	English
Τζορτζ	English
Τζούλια	English
Τζόι	English
Τζόναθαν	English
Τζόνι	English
Τζόνσον	English
Τζόουνς	English
Τζόρτζια	English
Τοντ	English
Τορόντο	English
τοστ	English
τρανς	English
Τσέλμσφορντ	English
τσίχλα	English
Τσακ	English
Τσαρλς	English
τσεκάρω	English
τσιπ	English
Τόμας	English
Τόνι	English
Υόρκη	English
φάρμα	English
Φίλιπ	English
Φίσερ	English
φαστ φουντ	English
φλερτ	English
Φλόριντα	English
χάκερ	English
χάμπουργκερ	English
Χάουαρντ	English
χάπι εντ	English
Χάρι	English
Χάρις	English
Χάρολντ	English
Χέμινγουεϊ	English
χένα	English
Χένρι	English
Χέρσεϊ	English
χίντι	English
Χαβάη	English
χακί	English
Χαλοουίν	English
χατ τρικ	English
Χιγκς	English
χιούμορ	English
χιτζάμπ	English
ψυχοσωματικός	English
ωογένεση	English
Όλιβερ	English
Άιφελ	French
έξτρα	French
α λα καρτ	French
αβανγκάρντ	French
αβαντάζ	French
Αγγλονορμανδικές Νήσοι	French
αγκαζέ	French
αδενίτιδα	French
αδρεναλίνη	French
αεροβίωση	French
αεροδρόμιο	French
αεροζόλ	French
αζούρ	French
αθεϊσμός	French
αθεϊστής	French
ακουαρέλα	French
ακροβασία	French
αλά	French
αλέ ρετούρ	French
Αλγερία	French
αλκάλιο	French
αλκαλοειδές	French
αλκαλοειδής	French
αλκοτέστ	French
αλμανάκ	French
αλτ	French
αλτερνατίβα	French
αμάλγαμα	French
αμορτισέρ	French
αμπέρ	French
αμπαζούρ	French
αμπαλάζ	French
αμπαλάρισμα	French
αμπαλάρω	French
αμπιγέ	French
αμπονέ	French
αμπρί	French
αμπραγιάζ	French
αμόκ	French
ανδρογόνο	French
Αντάντ	French
αντικέρ	French
αντικερί	French
αντισηπτικό	French
αντρέ	French
ανφάν-γκατέ	French
αξεσουάρ	French
αξιολογικός	French
απέταλος	French
απεριτίφ	French
απλίκα	French
απλολογία	French
αργκό	French
αρζαντέ	French
αριβίστας	French
ασανσέρ	French
ασετόν	French
ασιανολογία	French
ασορτί	French
ατμόσφαιρα	French
αυτόγραφο	French
αφίσα	French
αψέντι	French
βαλς	French
βαμπίρ	French
βενζίνη	French
βιζόν	French
βιολογία	French
βιταμίνη	French
βιτρίνα	French
βιόσφαιρα	French
βοτανική	French
βουλκανιζατέρ	French
Βρετάνη	French
βρώμιο	French
γάζα	French
γκαζόν	French
γκαρσόνι	French
γκρι	French
γλυκόζη	French
γραβάτα	French
γρανάζι	French
γυπαετός	French
δακτυλογράφος	French
δημοτική	French
δρύπη	French
εβαπορέ	French
εκλέρ	French
εκλαίρ	French
εμαγιέ	French
εμπειρισμός	French
εξπρές	French
εποποιία	French
εστέτ	French
εστραγκόν	French
ζέβρα	French
ζέμπρα	French
ζαμπόν	French
ζενίθ	French
ζούγκλα	French
ηωσίνη	French
θερμοδυναμική	French
ιαγουάρος	French
Ιαπωνία	French
ισλαμισμός	French
ιωδισμός	French
ιώδιο	French
Κάννες	French
καμβάς	French
Καμερούν	French
καμουφλάζ	French
καμουφλάρω	French
Καμπερνέ Σοβινιόν	French
Καμπότζη	French
καναπές	French
κανό	French
καρμανιόλα	French
καρτ-ποστάλ	French
κασκαντέρ	French
κασκόλ	French
καφέ	French
κεκ	French
κιλοβάτ	French
κινηματογραφία	French
κινηματογραφικός	French
κλικ	French
κλινική	French
κολιέ	French
κολιμπρί	French
κολλώδιο	French
κομεντί	French
κομμουνίστρια	French
κομμουνισμός	French
κομπέρ	French
κομπινεζόν	French
κομπρεσέρ	French
Κονγκό	French
κορ ανγκλέ	French
κορσές	French
κουαφέζα	French
κουντεπιέ	French
κουπ	French
κουστούμι	French
κραγιόν	French
κριτική	French
κόρυμβος	French
λικέρ	French
λιλά	French
μάγια	French
μαγιονέζα	French
μαγιό	French
μακιγιάζ	French
μακιγιέζ	French
μακιγιέρ	French
μανεκέν	French
μανικιούρ	French
μαοϊσμός	French
μασάζ	French
μασίς	French
μαόνι	French
μεγαλομανία	French
μεθοδολογία	French
μενού	French
μενταγιόν	French
μετρονόμος	French
μετρό	French
μικροσκόπιο	French
Μισέλ	French
μοβ	French
μοντάζ	French
μπαγκέτα	French
μπαλαντέρ	French
μπαμπάς	French
μπαράζ	French
μπαρδόν	French
μπεζ	French
Μπενίν	French
μπετόν	French
μπιγκουντί	French
μπικουτί	French
μπιμπερό	French
μπιφτέκι	French
μπλε	French
μπλε μαρέν	French
μπλε μαρίν	French
μπλουζόν	French
μπολ	French
μπουγιαμπέσα	French
μπουζί	French
μπουκέτο	French
Μπουρκίνα Φάσο	French
Μπουρούντι	French
μπουφάν	French
μπούκλα	French
μπρελόκ	French
μπροκαντέρ	French
μπροκαντερί	French
ναΐφ	French
ναδίρ	French
νοσταλγία	French
ντεκόρ	French
ντισπανσέρ	French
ντοκιμαντέρ	French
ντουί	French
ντουζ	French
ντουμπλάρω	French
ντους	French
Ντωφινέ	French
οβάλ	French
οικολογικός	French
ολόγραμμα	French
οξαλικός	French
οργανοληπτικός	French
οργανώνω	French
ορχιδέα	French
οτομπούς	French
οτοστόπ	French
ουβερτούρα	French
ουλάνος	French
πίστα	French
παιδίατρος	French
παλτό	French
πανέ	French
πανσιόν	French
παπιγιόν	French
Παρίσι	French
παραφωνία	French
παρμπρίζ	French
πατ	French
πεκάν	French
περιοδικό	French
περφορατέρ	French
πιόνι	French
πλαζ	French
πλασιέ	French
πλατίνα	French
πλατφόρμα	French
πολωνέζα	French
πορνογραφία	French
ποσέ	French
πουρμπουάρ	French
πρίζα	French
πρεμιέρα	French
Πωλ	French
ράδιο	French
ραντεβού	French
ραντό	French
ρεπεσάζ	French
ρεπό	French
ρεσεψιονίστ	French
ρεσεψιόν	French
ρεσιτάλ	French
ρετιρέ	French
ρεφρέν	French
ροζ	French
ροζέ	French
ροκφόρ	French
ρολό	French
ρόλος	French
σαμπάνια	French
σαμπανιζέ	French
σαμποτάζ	French
σαμποτέρ	French
σαντιγί	French
σαντιγύ	French
σαρκαστικός	French
σεβρό	French
σεζόν	French
σερίφης	French
σιδηρίτης	French
σικορέ	French
σινεμά	French
σιφόν	French
σοβινισμός	French
σοκ	French
σοκολάτα	French
σορμπέ	French
σος	French
σοσιαλισμός	French
σουβέρ	French
σουβενίρ	French
σουτιέν	French
σοφίτα	French
σούπα	French
σπορ	French
στηθοσκόπιο	French
στυλό	French
συμβιωτικός	French
συμβολισμός	French
συμμετρικός	French
σως	French
τέιο	French
τακτ	French
ταμπλό	French
ταξί	French
ταρό	French
τατουάζ	French
τερπένιο	French
τιρκουάζ	French
τιρμπουσόν	French
τουαλέτα	French
τρίκο	French
τρίκυκλο	French
τραβεστί	French
τρακάρω	French
τρακτέρ	French
τροτσκισμός	French
Τσαντ	French
τόνος	French
υδρόφιλος	French
υλοζωισμός	French
υπερτροφία	French
φαβορί	French
φεστιβάλ	French
φετίχ	French
φθόριο	French
φιλανθρωπικός	French
φιλελληνικός	French
φιλολογικός	French
φιξάρω	French
φλίπερ	French
φον ντε τεν	French
φραμπουάζ	French
φραπέ	French
χαλίφης	French
χαμίνι	French
χαρτομαντεία	French
χλώριο	French
ψευδώνυμο	French
ψυχίατρος	French
ψυχανάλυση	French
ψυχιατρική	French
ψυχιατρικός	French
ψυχοθεραπεία	French
ψυχολογία	French
ψυχολογικός	French
ψυχολόγος	French
ψυχραιμία	French
ψύχωση	French
ένζυμο	German
αλλεργία	German
Αμβούργο	German
Βερολίνο	German
βολφράμιο	German
γιοτ	German
δημοσκόπηση	German
ηωσίνη	German
ισόγλωσσο	German
κιτς	German
κριτική	German
Λάιμπνιτς	German
λούμπεν	German
Μάισνερ	German
Μπάουερ	German
Μπάουχαους	German
Μπάττενμπεργκ	German
Μπράουν	German
Μόναχο	German
ναζί	German
ναζισμός	German
οικολογικός	German
Στουτγκάρδη	German
τερπένιο	German
Φίλιπ	German
Φίσερ	German
φούτερ	German
Φραγκφούρτη	German
Φρανκφούρτη	German
ψυχανάλυση	German
ψυχοθεραπεία	German
άρια	Italian
αβάντζο	Italian
αβαντάρω	Italian
αβαντζάρω	Italian
αβαντσάρω	Italian
αβαράρω	Italian
αβαρία	Italian
Αβογκάντρο	Italian
αγαντάρω	Italian
ακομπανιάρω	Italian
ακομπανιαμέντο	Italian
ακουαφόρτε	Italian
αλέγκρο	Italian
αλέγρος	Italian
αλαμπουρνέζικος	Italian
αλεγράρω	Italian
αλιάδα	Italian
αλτάνα	Italian
αμάκα	Italian
αμπαλάρω	Italian
αμόρε	Italian
αντάντε	Italian
αντίκα	Italian
αντίο	Italian
απίκο	Italian
αριβάρω	Italian
αρλεκίνος	Italian
αρχιπέλαγος	Italian
βάζο	Italian
βέσπα	Italian
βίζιτα	Italian
βαλίτσα	Italian
βαρελότο	Italian
Βενετσιάνος	Italian
Βερόνικα	Italian
βιολέτα	Italian
βόλτα	Italian
Γένοβα	Italian
γαλόνι	Italian
γατόπαρδος	Italian
γιρλάντα	Italian
Γκαέτα	Italian
γκουβέρνο	Italian
γκρανκάσα	Italian
γράδο	Italian
εβίβα	Italian
Ερυθραία	Italian
εσπρέσο	Italian
ζαφείρι	Italian
Ιουλιέτα	Italian
κάλμα	Italian
κάπα	Italian
κάρτα	Italian
κάσα	Italian
καβίλια	Italian
καλαμπόκι	Italian
καλμάρω	Italian
κανέλα	Italian
καπέλο	Italian
καπουτσίνος	Italian
καράφα	Italian
καραμέλα	Italian
καραμπίνα	Italian
καριέρα	Italian
καρνάγιο	Italian
καρναβάλι	Italian
καρότσα	Italian
κασέτα	Italian
κατσαρόλα	Italian
κιάλι	Italian
κλαρίνο	Italian
κλαρινέτο	Italian
κολόνα	Italian
κολόνια	Italian
κομοδίνο	Italian
κομπρέσα	Italian
κοντούρα	Italian
κοντρολάρω	Italian
κοντσέρτο	Italian
κοτσάρω	Italian
κουνέλι	Italian
κουρτίνα	Italian
κρέμα	Italian
κριτσίνι	Italian
κόρνα	Italian
κόρνο	Italian
κόστος	Italian
λάμπα	Italian
λίγκα	Italian
λίμα	Italian
λίρα	Italian
λίστα	Italian
λεβάντες	Italian
λεβαντίνος	Italian
Λεονάρντο	Italian
λοκάντα	Italian
λοστρόμος	Italian
λουκέτο	Italian
μάγκας	Italian
Μάλτα	Italian
μάρκα	Italian
μαέστρος	Italian
μανιφέστο	Italian
μαρασκίνο	Italian
μαρκάρω	Italian
ματζόρε	Italian
μαφία	Italian
μετάλλιο	Italian
μι	Italian
Μιλάνο	Italian
μινόρε	Italian
μοντέλο	Italian
μοντέρνος	Italian
μπάνιο	Italian
μπάντα	Italian
μπάσος	Italian
μπέρτα	Italian
μπαλκόνι	Italian
μπιζέλι	Italian
μποτίλια	Italian
μπουνιά	Italian
μπουρδέλο	Italian
μπούνια	Italian
μπράβο	Italian
μπράτσο	Italian
μπρόκολο	Italian
μπύρα	Italian
μόρσο	Italian
νέρος	Italian
νούμερο	Italian
ντάμα	Italian
ντεραπάρω	Italian
ντο	Italian
οπερέτα	Italian
Ορλάνδος	Italian
πάντα	Italian
πάρκο	Italian
πάστα	Italian
πίκολο	Italian
πίπα	Italian
πίτσα	Italian
πακέτο	Italian
παντελόνι	Italian
παντόφλα	Italian
παπαγάλος	Italian
παρκάρω	Italian
παρόλα	Italian
πασαπόρτι	Italian
παστέλι	Italian
πιάτο	Italian
πιλοτάρω	Italian
πισίνα	Italian
πιτσούνι	Italian
πλατίνα	Italian
ποντάρω	Italian
πρέζα	Italian
πρεσάρω	Italian
πρόβα	Italian
πρόκα	Italian
ράδα	Italian
ρέστα	Italian
ραββίνος	Italian
ραμολιμέντο	Italian
ραντίτσιο	Italian
ρε	Italian
ρεζέρβα	Italian
ρεντίκολο	Italian
ρεπερτόριο	Italian
ρετάλι	Italian
ριζότο	Italian
ρομάντζο	Italian
ρομπαμπέκια	Italian
ρόκα	Italian
σάλι	Italian
σαλάμι	Italian
σαλτάρω	Italian
σελίνι	Italian
σερβιτόρος	Italian
σιρόπι	Italian
σκέτος	Italian
σκίτσο	Italian
σμάλτο	Italian
Σπέτσες	Italian
σπίρτο	Italian
στακάτο	Italian
στερλίνα	Italian
στρατσιατέλα	Italian
σόργο	Italian
τάλιρο	Italian
ταλέντο	Italian
ταπέτο	Italian
Τζούλια	Italian
τούμπα	Italian
τρένο	Italian
τρίπα αλά βενετσιάνα	Italian
τρακάρω	Italian
τσίγκος	Italian
τσαμπί	Italian
τσαμπούνα	Italian
τόνος	Italian
φάρσα	Italian
φάτσα	Italian
φαγκότο	Italian
φαντασία	Italian
φασίστας	Italian
φασίστρια	Italian
φασισμός	Italian
φασούλι	Italian
φινόκιο	Italian
φλάουτο	Italian
φλόκι	Italian
φουμάρω	Italian
φουριόζος	Italian
φρένο	Italian
φρέσκος	Italian
φόρμα	Italian
χαλίφης	Italian
όμποε	Italian
όπερα	Italian
άλμπουμ	Latin
α ποστεριόρι	Latin
Αίτνα	Latin
αβαντάρω	Latin
ακουμπώ	Latin
αλχημεία	Latin
απλίκα	Latin
αποστεριόρι	Latin
απριόρι	Latin
Αυστρία	Latin
Βαβαρία	Latin
Βαυαρία	Latin
γραικύλος	Latin
Ελβετία	Latin
κάψα	Latin
καπίστρι	Latin
Κολωνία	Latin
Λονδίνο	Latin
λούμεν	Latin
μαντήλι	Latin
μόρσο	Latin
πάνθεον	Latin
πανούκλα	Latin
Πετράρχης	Latin
Ρήνος	Latin
Σκανδιναβία	Latin
σούβλα	Latin
Σταβία	Latin
στράτα	Latin
Τεργέστη	Latin
τούμπα	Latin
φόρα	Latin
χούμος	Latin
άιντε	Ottoman Turkish
άτι	Ottoman Turkish
αγιάζι	Ottoman Turkish
αλάνι	Ottoman Turkish
αλατζάς	Ottoman Turkish
αλισβερίσι	Ottoman Turkish
αμάν	Ottoman Turkish
αμπάρι	Ottoman Turkish
αναντάν μπαμπαντάν	Ottoman Turkish
ανασόνι	Ottoman Turkish
αντέτι	Ottoman Turkish
αντερί	Ottoman Turkish
αράπης	Ottoman Turkish
αραλίκι	Ottoman Turkish
αραμπάς	Ottoman Turkish
αραμπατζής	Ottoman Turkish
αραπίνα	Ottoman Turkish
αρκαντάσης	Ottoman Turkish
αρμπεντές	Ottoman Turkish
ασικιαρέ	Ottoman Turkish
ασλάνι	Ottoman Turkish
αστάρι	Ottoman Turkish
αφιόνι	Ottoman Turkish
αχταρμάς	Ottoman Turkish
βαλκανικός	Ottoman Turkish
βασιβουζούκος	Ottoman Turkish
Βόλος	Ottoman Turkish
γενίτσαρος	Ottoman Turkish
γιαβρί	Ottoman Turkish
γιακάς	Ottoman Turkish
γιαπί	Ottoman Turkish
γιασεμί	Ottoman Turkish
γιατάκι	Ottoman Turkish
γιλέκο	Ottoman Turkish
γινάτι	Ottoman Turkish
γιουβέτσι	Ottoman Turkish
γιουχαΐζω	Ottoman Turkish
γκάιντα	Ottoman Turkish
γκέλα	Ottoman Turkish
γκεσέμι	Ottoman Turkish
γκιουρουλτί	Ottoman Turkish
δερβένι	Ottoman Turkish
ζαγάρι	Ottoman Turkish
ζαμάνι	Ottoman Turkish
ζαράρι	Ottoman Turkish
ζουμπάς	Ottoman Turkish
ζουμπούλι	Ottoman Turkish
ζουρνάς	Ottoman Turkish
ζόρι	Ottoman Turkish
ιμάμ μπαϊλντί	Ottoman Turkish
ιμάμης	Ottoman Turkish
ινάτι	Ottoman Turkish
ιραδές	Ottoman Turkish
κέφι	Ottoman Turkish
καΐκι	Ottoman Turkish
καλάι	Ottoman Turkish
καλέμι	Ottoman Turkish
καλαμπόκι	Ottoman Turkish
καλκάνι	Ottoman Turkish
καλντερίμι	Ottoman Turkish
καλούπι	Ottoman Turkish
καμπούρα	Ottoman Turkish
καμπούρης	Ottoman Turkish
καντάρι	Ottoman Turkish
καπάκι	Ottoman Turkish
καρα-	Ottoman Turkish
καραβάνι	Ottoman Turkish
καραβανσεράι	Ottoman Turkish
καραγκιοζιλίκι	Ottoman Turkish
Καραγκιόζης	Ottoman Turkish
καραμπογιά	Ottoman Turkish
καρπούζι	Ottoman Turkish
καφές	Ottoman Turkish
καφετζής	Ottoman Turkish
καϊμάκι	Ottoman Turkish
κεμπάπ	Ottoman Turkish
κεσέμι	Ottoman Turkish
κετσές	Ottoman Turkish
κεφτές	Ottoman Turkish
κεχριμπάρι	Ottoman Turkish
κιμάς	Ottoman Turkish
κινά	Ottoman Turkish
κουμάρι	Ottoman Turkish
κουνουπίδι	Ottoman Turkish
κουραμπιές	Ottoman Turkish
κουρασάνι	Ottoman Turkish
κουρκούτι	Ottoman Turkish
κουσούρι	Ottoman Turkish
κουτουράδα	Ottoman Turkish
κόπιτσα	Ottoman Turkish
λαγούμι	Ottoman Turkish
λατέρνα	Ottoman Turkish
λεκές	Ottoman Turkish
λιμάνι	Ottoman Turkish
λουκουμάς	Ottoman Turkish
λουκούμι	Ottoman Turkish
λουλάς	Ottoman Turkish
λούκι	Ottoman Turkish
μάγκας	Ottoman Turkish
μέγγενη	Ottoman Turkish
μαβί	Ottoman Turkish
μαγιά	Ottoman Turkish
μανάβης	Ottoman Turkish
μανάβικο	Ottoman Turkish
μαντέμι	Ottoman Turkish
μαραφέτι	Ottoman Turkish
μασιά	Ottoman Turkish
μαϊντανός	Ottoman Turkish
μεζές	Ottoman Turkish
μελτέμι	Ottoman Turkish
μενεξές	Ottoman Turkish
μενεξεδής	Ottoman Turkish
μεντεσές	Ottoman Turkish
μεράκι	Ottoman Turkish
μιναρές	Ottoman Turkish
μουεζίνης	Ottoman Turkish
μουρβέρι	Ottoman Turkish
μουσακάς	Ottoman Turkish
μουσαμάς	Ottoman Turkish
μπάμια	Ottoman Turkish
μπάτσος	Ottoman Turkish
μπαγιάτικος	Ottoman Turkish
μπαγλαμάς	Ottoman Turkish
μπακάλης	Ottoman Turkish
μπακλαβάς	Ottoman Turkish
μπαλτάς	Ottoman Turkish
μπαμπάς	Ottoman Turkish
μπασκίνας	Ottoman Turkish
μπατανία	Ottoman Turkish
μπαχάρι	Ottoman Turkish
μπεκιάρης	Ottoman Turkish
μπεκρής	Ottoman Turkish
μπελάς	Ottoman Turkish
μπερντές	Ottoman Turkish
μπινές	Ottoman Turkish
μπινελίκι	Ottoman Turkish
μπογιά	Ottoman Turkish
μπογιατζής	Ottoman Turkish
μπουγάζι	Ottoman Turkish
μπουζούκι	Ottoman Turkish
μπουντρούμι	Ottoman Turkish
μπουρέκι	Ottoman Turkish
μπουρνούζι	Ottoman Turkish
μπούτι	Ottoman Turkish
μπρίκι	Ottoman Turkish
μπόλικος	Ottoman Turkish
νάζι	Ottoman Turkish
νέφτι	Ottoman Turkish
νισάφι	Ottoman Turkish
νισαντήρι	Ottoman Turkish
νισεστές	Ottoman Turkish
ντάλα	Ottoman Turkish
ντέρτι	Ottoman Turkish
νταβατζής	Ottoman Turkish
νταντά	Ottoman Turkish
νταούλι	Ottoman Turkish
ντε	Ottoman Turkish
ντεμέκ	Ottoman Turkish
ντολμάς	Ottoman Turkish
ντουλάπι	Ottoman Turkish
ντουμάνι	Ottoman Turkish
ντουνιάς	Ottoman Turkish
ντουντούκα	Ottoman Turkish
νυστέρι	Ottoman Turkish
οκά	Ottoman Turkish
ουστ	Ottoman Turkish
παζάρι	Ottoman Turkish
παντεσπάνι	Ottoman Turkish
παντζάρι	Ottoman Turkish
παπάρα	Ottoman Turkish
παπούτσι	Ottoman Turkish
πεσκίρι	Ottoman Turkish
πεστιμάλι	Ottoman Turkish
πετιμέζι	Ottoman Turkish
πούλι	Ottoman Turkish
πούστης	Ottoman Turkish
πριτσίνι	Ottoman Turkish
ράφι	Ottoman Turkish
ραβέντι	Ottoman Turkish
ραγιάς	Ottoman Turkish
ρακή	Ottoman Turkish
Ραμαζάνι	Ottoman Turkish
ρεζίλι	Ottoman Turkish
ρουσφέτι	Ottoman Turkish
σαΐνι	Ottoman Turkish
σαγάνι	Ottoman Turkish
σαγανάκι	Ottoman Turkish
σακάτης	Ottoman Turkish
σαλβάρι	Ottoman Turkish
σαντούρι	Ottoman Turkish
σεβντάς	Ottoman Turkish
σεργιάνι	Ottoman Turkish
σερμαγιά	Ottoman Turkish
σιμίτι	Ottoman Turkish
σινάφι	Ottoman Turkish
σιντριβάνι	Ottoman Turkish
σιχτίρ	Ottoman Turkish
σοβάς	Ottoman Turkish
σοκάκι	Ottoman Turkish
σουλτάνος	Ottoman Turkish
σουτζούκι	Ottoman Turkish
σοφάς	Ottoman Turkish
σόι	Ottoman Turkish
τέλι	Ottoman Turkish
ταβάνι	Ottoman Turkish
ταβάς	Ottoman Turkish
ταμπάκης	Ottoman Turkish
ταμπουράς	Ottoman Turkish
ταραμάς	Ottoman Turkish
ταχίνι	Ottoman Turkish
ταψί	Ottoman Turkish
τεμενάς	Ottoman Turkish
τεμπέλης	Ottoman Turkish
τεμπεσίρι	Ottoman Turkish
τεπές	Ottoman Turkish
τεφτέρι	Ottoman Turkish
τζάμι	Ottoman Turkish
τζάμπα	Ottoman Turkish
τζάνερο	Ottoman Turkish
τζίνι	Ottoman Turkish
τζαμί	Ottoman Turkish
τζατζίκι	Ottoman Turkish
τζερεμές	Ottoman Turkish
τζερτζελές	Ottoman Turkish
τζιγέρι	Ottoman Turkish
τζουράς	Ottoman Turkish
τουλούμι	Ottoman Turkish
τουμπελέκι	Ottoman Turkish
τσάγαλο	Ottoman Turkish
τσάι	Ottoman Turkish
τσάντα	Ottoman Turkish
τσίπουρο	Ottoman Turkish
τσίσα	Ottoman Turkish
τσίσια	Ottoman Turkish
τσακάλι	Ottoman Turkish
τσακίρ κέφι	Ottoman Turkish
τσακμάκι	Ottoman Turkish
τσαμπουκάς	Ottoman Turkish
τσανάκα	Ottoman Turkish
τσεμπέρι	Ottoman Turkish
τσιγκέλι	Ottoman Turkish
τσιγκούνης	Ottoman Turkish
τσιμπούκι	Ottoman Turkish
τσιράκι	Ottoman Turkish
τσιφούτης	Ottoman Turkish
τσογλάνι	Ottoman Turkish
Τσολάκης	Ottoman Turkish
τσουράπι	Ottoman Turkish
τσουρέκι	Ottoman Turkish
τσόλι	Ottoman Turkish
φέσι	Ottoman Turkish
φίλντισι	Ottoman Turkish
φαρσί	Ottoman Turkish
φιντάνι	Ottoman Turkish
φισέκι	Ottoman Turkish
φιτίλι	Ottoman Turkish
φλιτζάνι	Ottoman Turkish
φουντούκι	Ottoman Turkish
φουφού	Ottoman Turkish
φραντζόλα	Ottoman Turkish
χάλι	Ottoman Turkish
χάνι	Ottoman Turkish
χάπι	Ottoman Turkish
χαζός	Ottoman Turkish
χαλί	Ottoman Turkish
χαλίφης	Ottoman Turkish
χαλβάς	Ottoman Turkish
χαμάμ	Ottoman Turkish
χαμπάρι	Ottoman Turkish
χαμπέρι	Ottoman Turkish
χαράμι	Ottoman Turkish
χαρέμι	Ottoman Turkish
χαρτζιλίκι	Ottoman Turkish
χασάπης	Ottoman Turkish
χασάπικο	Ottoman Turkish
χουρμάς	Ottoman Turkish
χούμους	Ottoman Turkish
αστάρι	Persian
ζουρνάς	Persian
καραβάνι	Persian
λεκές	Persian
μασιά	Persian
μεζές	Persian
μενεξεδής	Persian
μεντεσές	Persian
μπάτσος	Persian
ντέρτι	Persian
ντουλάπι	Persian
Ορμούζ	Persian
πεσκίρι	Persian
πούλι	Persian
σαντούρι	Persian
ταβάς	Persian
ταμπουράς	Persian
τζουράς	Persian
τσακάλι	Persian
τσεμπέρι	Persian
τσιράκι	Persian
τσουράπι	Persian
γκάσμα	Arabic
γκίμπνα	Arabic
ζιμπάλα	Arabic
κόχλι	Arabic
λάμπαν	Arabic
λίμπ	Arabic
μάτμπαχ	Arabic
μαντράσα	Arabic
μασούρι	Arabic
μπαλάτι	Arabic
μπατανία	Arabic
μπεντ	Arabic
μπουάπα	Arabic
μπουάπης	Arabic
ντούρα	Arabic
νόκτα	Arabic
σιμίτ	Arabic
φαλάφα	Arabic
φαλάφελ	Arabic
χαμσίνι	Arabic
χαρτούμι	Arabic