abaton	Ancient Greek
abulia	Ancient Greek
acanzio	Ancient Greek
acatalessia	Ancient Greek
acroamatico	Ancient Greek
acustico	Ancient Greek
aedo	Ancient Greek
aero-	Ancient Greek
afasia	Ancient Greek
afonia	Ancient Greek
aforistico	Ancient Greek
agalassia	Ancient Greek
agalattia	Ancient Greek
agnosia	Ancient Greek
Akragas	Ancient Greek
alabastro	Ancient Greek
alieutica	Ancient Greek
alieutico	Ancient Greek
allotrio	Ancient Greek
alma	Ancient Greek
aloe	Ancient Greek
amartia	Ancient Greek
amen	Ancient Greek
amorfo	Ancient Greek
Amorgo	Ancient Greek
anadiomene	Ancient Greek
anamorfosi	Ancient Greek
anancastico	Ancient Greek
ananche	Ancient Greek
anatessi	Ancient Greek
andracne	Ancient Greek
anonimia	Ancient Greek
aorta	Ancient Greek
apocope	Ancient Greek
apodissi	Ancient Greek
apologista	Ancient Greek
apotropaico	Ancient Greek
aprassia	Ancient Greek
arbelo	Ancient Greek
archegete	Ancient Greek
archè	Ancient Greek
areo-	Ancient Greek
argiraspide	Ancient Greek
ariballo	Ancient Greek
arista	Ancient Greek
Aristarco	Ancient Greek
asceterio	Ancient Greek
asfissia	Ancient Greek
Asia	Ancient Greek
atassia	Ancient Greek
atticismo	Ancient Greek
autarchia	Ancient Greek
autocefalo	Ancient Greek
autopsia	Ancient Greek
autoschediastico	Ancient Greek
azzimo	Ancient Greek
basilissa	Ancient Greek
Batone	Ancient Greek
batrace	Ancient Greek
Berenice	Ancient Greek
bibliografia	Ancient Greek
botro	Ancient Greek
bradipo	Ancient Greek
brefotrofio	Ancient Greek
bruma	Ancient Greek
calamita	Ancient Greek
calligrafico	Ancient Greek
carcino	Ancient Greek
Caronda	Ancient Greek
carpo	Ancient Greek
catastematico	Ancient Greek
catasterismo	Ancient Greek
categoria	Ancient Greek
cefalio	Ancient Greek
Cefalonia	Ancient Greek
ceroplastica	Ancient Greek
chiliagono	Ancient Greek
cilindrico	Ancient Greek
cimelio	Ancient Greek
clado-	Ancient Greek
Clitennestra	Ancient Greek
clone	Ancient Greek
coma	Ancient Greek
coprofago	Ancient Greek
coracia	Ancient Greek
corago	Ancient Greek
coregico	Ancient Greek
corego	Ancient Greek
corografico	Ancient Greek
corografo	Ancient Greek
cosmopolita	Ancient Greek
crasi	Ancient Greek
crono-	Ancient Greek
dadoforo	Ancient Greek
Decameron	Ancient Greek
demotico	Ancient Greek
didascalia	Ancient Greek
dimorfo	Ancient Greek
diocesi	Ancient Greek
doga	Ancient Greek
domazio	Ancient Greek
dromo	Ancient Greek
dromos	Ancient Greek
dulosi	Ancient Greek
ecatostilo	Ancient Greek
ecdisi	Ancient Greek
ecfrastico	Ancient Greek
ecumene	Ancient Greek
Efesto	Ancient Greek
electron	Ancient Greek
elegiambo	Ancient Greek
elicoide	Ancient Greek
eliotropio	Ancient Greek
Elisabetta	Ancient Greek
emagogo	Ancient Greek
ematico	Ancient Greek
ematoide	Ancient Greek
emiono	Ancient Greek
emo-	Ancient Greek
encorio	Ancient Greek
endogeno	Ancient Greek
energetico	Ancient Greek
Enio	Ancient Greek
epentetico	Ancient Greek
Epifania	Ancient Greek
epifragma	Ancient Greek
epinetro	Ancient Greek
epiploon	Ancient Greek
epirrema	Ancient Greek
eponimo	Ancient Greek
epulide	Ancient Greek
eracliteo	Ancient Greek
Ermacora	Ancient Greek
Ero	Ancient Greek
eroo	Ancient Greek
Esaù	Ancient Greek
esoterico	Ancient Greek
essoterico	Ancient Greek
Ettore	Ancient Greek
eureka	Ancient Greek
Eurialo	Ancient Greek
Euterpe	Ancient Greek
falca	Ancient Greek
falò	Ancient Greek
fantasma	Ancient Greek
Filippi	Ancient Greek
fillo	Ancient Greek
galattofago	Ancient Greek
gamelia	Ancient Greek
Gange	Ancient Greek
genia	Ancient Greek
gheppio	Ancient Greek
girino	Ancient Greek
glena	Ancient Greek
glenoide	Ancient Greek
gnostico	Ancient Greek
graffire	Ancient Greek
Gregorio	Ancient Greek
heroon	Ancient Greek
Iambe	Ancient Greek
Ifigenia	Ancient Greek
ilarotragedia	Ancient Greek
Ilion	Ancient Greek
ipetro	Ancient Greek
ipocoristico	Ancient Greek
ipotesi	Ancient Greek
ippiatra	Ancient Greek
iresione	Ancient Greek
iride	Ancient Greek
iris	Ancient Greek
iso-	Ancient Greek
ittiofago	Ancient Greek
lampadedromia	Ancient Greek
Lampedusa	Ancient Greek
Laocoonte	Ancient Greek
Larissa	Ancient Greek
Leandro	Ancient Greek
liturgo	Ancient Greek
locago	Ancient Greek
lotofago	Ancient Greek
malobatro	Ancient Greek
mazzero	Ancient Greek
megalo-	Ancient Greek
Megera	Ancient Greek
meliambo	Ancient Greek
melo	Ancient Greek
Melpomene	Ancient Greek
meso	Ancient Greek
metabole	Ancient Greek
metrica	Ancient Greek
misantropia	Ancient Greek
mitologema	Ancient Greek
mnemonico	Ancient Greek
Momo	Ancient Greek
monorchide	Ancient Greek
monotonia	Ancient Greek
monotono	Ancient Greek
monottongo	Ancient Greek
morfo-	Ancient Greek
Naos	Ancient Greek
nazireo	Ancient Greek
nestore	Ancient Greek
Nicandro	Ancient Greek
noumeno	Ancient Greek
ofide	Ancient Greek
oinochoe	Ancient Greek
oligo-	Ancient Greek
omofago	Ancient Greek
omoforio	Ancient Greek
omologo	Ancient Greek
onomastico	Ancient Greek
orgiastico	Ancient Greek
ossitono	Ancient Greek
ostracizzare	Ancient Greek
ottagono	Ancient Greek
pado	Ancient Greek
Pandora	Ancient Greek
panoplia	Ancient Greek
pantocratore	Ancient Greek
paralio	Ancient Greek
paredro	Ancient Greek
paresi	Ancient Greek
Paride	Ancient Greek
Parmenide	Ancient Greek
parossitono	Ancient Greek
patra	Ancient Greek
pedio	Ancient Greek
penta-	Ancient Greek
pentastico	Ancient Greek
Pentateuco	Ancient Greek
pentathlon	Ancient Greek
pentatleta	Ancient Greek
pentecontera	Ancient Greek
pentecto	Ancient Greek
pepsi	Ancient Greek
perieco	Ancient Greek
perifrasi	Ancient Greek
perigeo	Ancient Greek
periodeute	Ancient Greek
Persefone	Ancient Greek
Perseo	Ancient Greek
picnostilo	Ancient Greek
pinace	Ancient Greek
pinaco-	Ancient Greek
pinax	Ancient Greek
pletro	Ancient Greek
polemico	Ancient Greek
polemizzare	Ancient Greek
policromo	Ancient Greek
Polidoro	Ancient Greek
polifonia	Ancient Greek
polilalia	Ancient Greek
polimorfo	Ancient Greek
polisemo	Ancient Greek
prassi	Ancient Greek
priamide	Ancient Greek
Priene	Ancient Greek
Prometeo	Ancient Greek
proparossitono	Ancient Greek
prostetico	Ancient Greek
protome	Ancient Greek
psichico	Ancient Greek
rachitismo	Ancient Greek
rapsodia	Ancient Greek
rapsodico	Ancient Greek
rapsodo	Ancient Greek
rino-	Ancient Greek
ritidoma	Ancient Greek
Romeo	Ancient Greek
sarissa	Ancient Greek
scia-	Ancient Greek
sclerofillo	Ancient Greek
Selena	Ancient Greek
Selenia	Ancient Greek
Selenio	Ancient Greek
Seleno	Ancient Greek
semeiotico	Ancient Greek
semiotico	Ancient Greek
simpatetico	Ancient Greek
simpatico	Ancient Greek
sinallagma	Ancient Greek
sinecie	Ancient Greek
singrafe	Ancient Greek
sinizesi	Ancient Greek
sintattico	Ancient Greek
sintonia	Ancient Greek
Sisifo	Ancient Greek
skyphos	Ancient Greek
Socrate	Ancient Greek
solecizzare	Ancient Greek
soma	Ancient Greek
somatico	Ancient Greek
spata	Ancient Greek
steca	Ancient Greek
sticario	Ancient Greek
stoa	Ancient Greek
strabismo	Ancient Greek
strobilo	Ancient Greek
tagma	Ancient Greek
tago	Ancient Greek
tallo	Ancient Greek
Tanato	Ancient Greek
Tartaro	Ancient Greek
tecio	Ancient Greek
telefio	Ancient Greek
telico	Ancient Greek
teosofo	Ancient Greek
Terpandro	Ancient Greek
theta	Ancient Greek
Trebisonda	Ancient Greek
tricoma	Ancient Greek
trimorfo	Ancient Greek
triodio	Ancient Greek
tristico	Ancient Greek
trittongo	Ancient Greek
troglio	Ancient Greek
trombo	Ancient Greek
trombosi	Ancient Greek
Urania	Ancient Greek
Uranie	Ancient Greek
ureo	Ancient Greek
xilo-	Ancient Greek
zacintio	Ancient Greek
Zacinto	Ancient Greek
zigote	Ancient Greek
abaya	Arabic
agemina	Arabic
ain	Arabic
albagio	Arabic
Alcamo	Arabic
Alcantara	Arabic
alfa	Arabic
Algeri	Arabic
Algieba	Arabic
alif	Arabic
almagesto	Arabic
almucantarat	Arabic
amostante	Arabic
Ankaa	Arabic
Arafat	Arabic
atanor	Arabic
azzurro	Arabic
bagarino	Arabic
baggala	Arabic
baobab	Arabic
barda	Arabic
bardassa	Arabic
Betelgeuse	Arabic
bottarga	Arabic
burnus	Arabic
buzzico	Arabic
cabila	Arabic
cafro	Arabic
calafatare	Arabic
Caltanissetta	Arabic
cangia	Arabic
carciofo	Arabic
cassero	Arabic
cassida	Arabic
cerbottana	Arabic
chitarra	Arabic
copto	Arabic
cotone	Arabic
cremisi	Arabic
curcuma	Arabic
darabukka	Arabic
Diphda	Arabic
divano	Arabic
Elnath	Arabic
Eltanin	Arabic
Enif	Arabic
fatwa	Arabic
fellah	Arabic
Fomalhaut	Arabic
fondaco	Arabic
gabella	Arabic
gara	Arabic
garbo	Arabic
gebel	Arabic
gelsomino	Arabic
ghibli	Arabic
ghirba	Arabic
Giaffa	Arabic
giarda	Arabic
giargone	Arabic
Gienah	Arabic
giraffa	Arabic
giubba	Arabic
giuggiolena	Arabic
giulebbe	Arabic
gomena	Arabic
Hamal	Arabic
henna	Arabic
hijab	Arabic
Hussein	Arabic
intifada	Arabic
kefiah	Arabic
Khaled	Arabic
Kochab	Arabic
lima	Arabic
madrasa	Arabic
maona	Arabic
mazzera	Arabic
meschino	Arabic
mesciroba	Arabic
mihrab	Arabic
Mizar	Arabic
moca	Arabic
mocaiardo	Arabic
moka	Arabic
muftì	Arabic
musalla	Arabic
nanfa	Arabic
qafiz	Arabic
qubba	Arabic
risma	Arabic
sacro	Arabic
Saddam	Arabic
saia	Arabic
Saladino	Arabic
sambuco	Arabic
sansa	Arabic
sceriffo	Arabic
sciabecco	Arabic
sciabica	Arabic
sciarmutta	Arabic
scirocco	Arabic
seghife	Arabic
senna	Arabic
sensale	Arabic
shari'a	Arabic
soda	Arabic
sunna	Arabic
sura	Arabic
tafferuglio	Arabic
tamarro	Arabic
tarbuscio	Arabic
tarocco	Arabic
tarsia	Arabic
tarì	Arabic
turcimanno	Arabic
uadi	Arabic
valigia	Arabic
zafferano	Arabic
zar	Arabic
zecca	Arabic
zeriba	Arabic
ziro	Arabic
zucchero	Arabic
archibugio	Dutch
batik	Dutch
Devos	Dutch
farabutto	Dutch
fiammingo	Dutch
ghis	Dutch
Ingrid	Dutch
laccamuffa	Dutch
lasta	Dutch
orca	Dutch
paviano	Dutch
pompelmo	Dutch
statolder	Dutch
Vanvitelli	Dutch
account	English
ace	English
Adeano	English
advocacy	English
aeroclub	English
agent	English
agnosticismo	English
agnostico	English
agreement	English
agribusiness	English
AIDS	English
airbag	English
aiscrìma	English
Alabama	English
Alasca	English
alligatore	English
ammonal	English
amplitron	English
anchorman	English
anfetamina	English
antidiluviano	English
antifa	English
antismog	English
antistress	English
app	English
appeal	English
Apple	English
Arizona	English
Arkansas	English
armonica	English
art director	English
ASCII	English
asdic	English
asset	English
assist	English
atollo	English
audience	English
austerity	English
autofocus	English
automotive	English
autoreverse	English
avatar	English
babla	English
baby	English
baby-doll	English
baby-sitter	English
babysitter	English
bachelite	English
backgammon	English
background	English
backstage	English
backtaxi	English
backup	English
bacon	English
bad boy	English
badminton	English
bail in	English
bailout	English
banana republic	English
bandana	English
banqueting	English
bar	English
barn	English
baseball	English
basic	English
BASIC	English
beat	English
beauty contest	English
bed and breakfast	English
benefit	English
best seller	English
best-seller	English
bestseller	English
Big Mac	English
bike	English
biker	English
binder	English
binge drinking	English
bingo	English
biofeedback	English
biogas	English
bionica	English
bioregione	English
bipartisan	English
birdwatching	English
bistecca	English
bite	English
blended learning	English
blitz	English
blog	English
blogger	English
blue-jeans	English
bluegrass	English
blues	English
bluetooth	English
bluff	English
bluffare	English
body shaming	English
boicottare	English
boiler	English
bombastico	English
bonango	English
bookmaker	English
boom	English
boomer	English
boss	English
boutique hotel	English
bowling	English
boxer	English
boyscout	English
brand	English
brandy	English
break	English
bridge	English
briefing	English
bro	English
broker	English
browser	English
brunch	English
Buchanan	English
budget	English
buffer	English
bull market	English
bungalow	English
Bush	English
business	English
buyout	English
bypass	English
byte	English
bàrista	English
cab	English
caca	English
cache	English
cachi	English
California	English
call center	English
camala	English
cameo	English
cameraman	English
camper	English
camping	English
Canterbury	English
Canton	English
capetoniano	English
capoc	English
carbon neutral	English
carborundum	English
card	English
cast	English
casting	English
catcalling	English
cent	English
chador	English
Chandler	English
charter	English
chat	English
che sarà, sarà	English
chea	English
check-in	English
cheesecake	English
Chicago	English
chickasaw	English
chip	English
chutney	English
ciber-	English
cibernetica	English
cis	English
city	English
clacson	English
clan	English
clearance	English
clic	English
click	English
Clinton	English
clip	English
cloche	English
clone	English
clown	English
club	English
cnoidale	English
coach	English
cobego	English
cocktail	English
Colorado	English
combine	English
combo	English
comfort zone	English
commodoro	English
compost	English
computer	English
condom	English
Connecticut	English
contact tracing	English
container	English
content creator	English
copyright	English
corgi	English
corner	English
cotidale	English
coulomb	English
coulrofobia	English
country	English
coyote	English
craccare	English
crawl	English
cricket	English
cringe	English
criogenico	English
Cronut	English
cross	English
cruciale	English
crunch	English
crush	English
cummingtonite	English
curry	English
cutter	English
cyborg	English
Dalek	English
dark	English
David	English
day after	English
deb	English
debunker	English
decibel	English
deck	English
deep learning	English
deepfake	English
deficit	English
dego	English
Delaware	English
deplatforming	English
derby	English
design	English
designer	English
desktop	English
dicco	English
dingo	English
Disney	English
dispenser	English
dissing	English
disturbanza	English
DNA	English
dogo	English
doorstepping	English
dopare	English
doping	English
download	English
downtown	English
dreadnought	English
dress code	English
drink	English
drip	English
driver	English
drone	English
droplet	English
dugongo	English
e-book	English
e-reader	English
elettrone	English
Elsinore	English
emoticon	English
empowerment	English
equalizzare	English
equalizzazione	English
escalation	English
escape	English
escapismo	English
eugenico	English
euro	English
evergreen	English
exit strategy	English
facepalm	English
fair play	English
falla	English
fan	English
Far West	English
fat shaming	English
feeling	English
festival	English
fiberglass	English
file	English
film	English
fist bump	English
fist pump	English
flare	English
flash	English
flashback	English
flirtare	English
floppy disk	English
Florida	English
focus group	English
folclore	English
fondamentalismo	English
fonografo	English
formica	English
forum	English
fricativa	English
fricativo	English
fricchettone	English
friend zone	English
friendzonare	English
friendzone	English
gadget	English
gag	English
gallone	English
gang	English
gangster	English
gay	English
gazebo	English
geco	English
gei	English
gender gap	English
genetica	English
George	English
Getty	English
ghenga	English
ghinea	English
giaurro	English
gibibyte	English
gigaflop	English
gincana	English
ginnare	English
giungla	English
glass ceiling	English
goal	English
goalball	English
gol	English
golf	English
Gondi	English
Google	English
gospel	English
gossip	English
grabbare	English
green pass	English
grigione	English
grizzly	English
groccare	English
guarano	English
guardrail	English
Guernsey	English
guideline	English
Halloween	English
handicap	English
Hawaii	English
heavy metal	English
Hepburn	English
hobbit	English
hobby	English
hockey	English
holding	English
home	English
hostess	English
hot dog	English
hoy	English
hub	English
humour	English
hybrid learning	English
iceberg	English
Idaho	English
identikit	English
Illinois	English
impatto	English
impeachment	English
importare	English
improvement	English
incantèsimo	English
incel	English
Indiana	English
indoor	English
infowar	English
Ingrid	English
insider trading	English
intelligence	English
internet	English
Internet	English
intranet	English
inverter	English
ione	English
Iowa	English
IPA	English
Irlanda	English
isolazionista	English
item	English
iuta	English
J	English
jab	English
jazz	English
Jean	English
jeans	English
jeep	English
jet lag	English
job	English
Joel	English
jogging	English
John	English
jolly	English
joyciano	English
joystick	English
juke-box	English
Kansas	English
kart	English
Kent	English
Kentucky	English
Keynes	English
killer	English
know-how	English
koala	English
kumquat	English
lacrosse	English
lady	English
lap dance	English
laser	English
lasso	English
latin lover	English
leader	English
leadership	English
leprecauno	English
leprechaun	English
lifting	English
lime	English
line	English
link	English
linoleum	English
live	English
lob	English
lobby	English
locavoro	English
lockdown	English
loggare	English
login	English
logo	English
logon	English
logout	English
lollardo	English
lolz	English
long play	English
lord	English
Los Angeles	English
love story	English
Luisiana	English
made in Italy	English
magazine	English
Maine	English
mainframe	English
malto	English
malware	English
mana	English
management	English
manager	English
manciù	English
mandatorio	English
mango	English
mangrovia	English
manitoba	English
manèga	English
marijuana	English
marine	English
marketing	English
Maryland	English
Massachusetts	English
match	English
meeting	English
meeting point	English
megabit	English
megabyte	English
megastore	English
megavolt	English
megawatt	English
melting pot	English
metal	English
metaldetector	English
metrosessuale	English
Miami	English
Michael	English
Michigan	English
microchip	English
microcomputer	English
microfilm	English
microohm	English
microvolt	English
mifepristone	English
millibar	English
millicurie	English
millimicron	English
millivolt	English
milord	English
mindfulness	English
minibar	English
minicomputer	English
minigolf	English
minimal	English
minimarket	English
minivan	English
Minnesota	English
Mississippi	English
Missouri	English
mister	English
misunderstanding	English
moa	English
mobbing	English
modacrilica	English
monitor	English
monitore	English
monokini	English
monotype	English
Montana	English
montgomery	English
morphare	English
motocross	English
motorcaravan	English
mountain bike	English
mouse	English
multimedia	English
multiplexare	English
mumble rap	English
muone	English
Murray	English
musical	English
mìlchibar	English
mìsta	English
nabla	English
Nebraska	English
neck	English
nerfare	English
netizen	English
neutrone	English
Nevada	English
New Hampshire	English
New Jersey	English
New York	English
Newcastle	English
night	English
niubbo	English
no	English
nocicettore	English
nursery	English
Ohio	English
Oklahoma	English
olomittico	English
online	English
open space	English
opinion leader	English
opinion maker	English
optional	English
orangutan	English
Oregon	English
outfit	English
outsider	English
outsourcing	English
overcloccare	English
overdose	English
painta	English
pallet	English
pamphlet	English
pandemonio	English
panel	English
pangolino	English
parasailing	English
parental control	English
paria	English
parsec	English
partner	English
party	English
password	English
patchwork	English
Paul	English
Pennsylvania	English
pennì	English
pentecostale	English
performance	English
performare	English
pet therapy	English
Peter	English
Phobos	English
photo finish	English
piccare	English
picnic	English
piercing	English
pigiama	English
pile	English
ping pong	English
pinnacolo	English
pisquano	English
plaid	English
planare	English
plank	English
plastic free	English
play	English
playlist	English
playoff	English
plugo	English
plumcake	English
podcast	English
poker	English
Polandball	English
pole position	English
polo	English
pomelo	English
ponce	English
pony	English
pop-corn	English
post	English
post-it	English
premier	English
princisbecco	English
privacy	English
pro	English
proof of concept	English
protone	English
provider	English
proxy	English
psichedelia	English
psichedelico	English
pub	English
pullover	English
pulsimetro	English
pusher	English
puzzle	English
quacchero	English
quark	English
quittare	English
racket	English
radar	English
radical-chic	English
ragamuffin	English
raid	English
rally	English
ranch	English
ratelo	English
Reagan	English
reality	English
reality show	English
reception	English
recital	English
record	English
recovery plan	English
refil	English
remainder	English
remake	English
replay	English
reporter	English
resettare	English
retroammiraglio	English
retrofit	English
revival	English
revolver	English
Rhode Island	English
riff	English
Robert	English
rock	English
Rockefeller	English
romantico	English
rosbif	English
round	English
royalty	English
rugby	English
rum	English
runner	English
sagù	English
sahib	English
saloon	English
sanderista	English
sandwich	English
sapodilla	English
scalpo	English
scellino	English
sceriffo	English
scevà	English
schwa	English
sciamano	English
scioccare	English
sciuscià	English
scoop	English
scooter	English
scotch	English
scratch	English
screenshot	English
scèra	English
self-made man	English
sentiment	English
serial killer	English
set	English
settare	English
setter	English
sexy	English
shake	English
shaker	English
shampoo	English
sherpa	English
sherry	English
sho	English
shock	English
shopping	English
short	English
shortcake	English
silverplate	English
single	English
sitcom	English
skateare	English
sketch	English
skincare	English
skipper	English
skyfarm	English
skyline	English
slab	English
slogan	English
slut-shaming	English
smartphone	English
smash	English
smog	English
sniffare	English
snob	English
snorkeling	English
social network	English
soft	English
software	English
sol	English
soma	English
soul	English
sound	English
spaghetti western	English
spam	English
spammare	English
speaker	English
speed date	English
spelling	English
spider	English
spillover	English
spin	English
spinnaker	English
spoiler	English
sponsor	English
spoonerismo	English
sport	English
spot	English
spratto	English
spread	English
sprint	English
sprue	English
staff	English
stallo	English
stand	English
standard	English
standing ovation	English
star	English
starlet	English
starter	English
steam cracking	English
sterlina	English
stick	English
stilb	English
stock	English
stop	English
stress	English
stress test	English
stretching	English
strip-tease	English
subdirectory	English
subroutine	English
summit	English
supercalifragilistichespiralidoso	English
superluminale	English
superman	English
supermarket	English
superstar	English
supporter	English
surf	English
surfare	English
surfista	English
suspense	English
suspenser	English
Sutherland	English
swing	English
Sydney	English
t-shirt	English
tabloid	English
takeaway	English
tanca	English
tandem	English
tangelo	English
tank	English
Taser	English
task force	English
team	English
tecnostress	English
teflon	English
telemarketing	English
teletext	English
telethon	English
Tennessee	English
tennis	English
terrier	English
test	English
teste	English
testimonial	English
testo	English
tetrapak	English
Texas	English
texture	English
thread	English
thriller	English
thrilling	English
throughput	English
ticket	English
tie-break	English
tight	English
tilt	English
timer	English
toast	English
Tony	English
top	English
top ten	English
topless	English
tornado	English
totem	English
touch	English
tram	English
trance	English
transfer	English
transistor	English
tranvai	English
trash	English
trial	English
trimarano	English
troll	English
trollare	English
trust	English
tryhardare	English
tunnel	English
uau	English
UEFA	English
ufo	English
ugrico	English
uligano	English
Ultima Thule	English
underdog	English
underground	English
understatement	English
unisex	English
upcycling	English
uppercut	English
USA	English
username	English
Utah	English
vamp	English
vee-jay	English
vegano	English
Vermont	English
video	English
videogame	English
videotape	English
Virginia	English
volt	English
vombato	English
voucher	English
vudù	English
vuvuzela	English
wad	English
wafer	English
walkman	English
wallaby	English
Walter	English
warrant	English
Washington	English
waterproof	English
watt	English
web	English
webcam	English
wedding planner	English
weekend	English
welfare	English
wellerismo	English
wellness	English
welter	English
Wendy	English
west	English
western	English
whig	English
whisky	English
whist	English
wifi	English
wigwam	English
Wikipedia	English
wimpzilla	English
win-win	English
windsurf	English
wireless	English
Wisconsin	English
word processing	English
word processor	English
Wyoming	English
yacht	English
Yankee	English
yard	English
yiddish	English
yo-yo	English
York	English
yuppie	English
zoom	English
abat-jour	French
abbandonico	French
abbigliamento	French
abbigliare	French
abbonare	French
abbordare	French
abrasivo	French
abregé	French
acagiù	French
acchitare	French
acchito	French
acclimatare	French
acromegalia	French
acustica	French
addizionare	French
Adele	French
aeroplano	French
aerostiere	French
affabulare	French
affaire	French
aggiustaggio	French
aggiustore	French
agire	French
aguti	French
alambicco	French
alare	French
Aleppo	French
alesare	French
alienista	French
alleanza	French
alleare	French
alleggio	French
allegro	French
almea	French
Alphandery	French
alé	French
amateur	French
amile	French
amoerro	French
ampere	French
ampère	French
analizzare	French
antinatalismi	French
antipodismo	French
antipodista	French
Anversa	French
aplomb	French
appretto	French
approcciare	French
ara	French
armagnac	French
Armando	French
arpagone	French
arpone	French
arrivista	French
arrière-goût	French
arrière-pensée	French
artigliere	French
artiglieria	French
aspic	French
assemblare	French
assemblea	French
assopire	French
atelier	French
atout	French
attrazzo	French
au-dessus de la mêlée	French
aurica	French
aurignaziano	French
autobus	French
autoclave	French
autocrazia	French
autodidatta	French
autodromo	French
automatico	French
autorizzare	French
autostop	French
avallo	French
avamposto	French
avance	French
aviatore	French
aviazione	French
avulsivo	French
avvantaggiare	French
azione	French
azoto	French
azzardo	French
baccarà	French
baccelliere	French
bagarre	French
bagascia	French
baia	French
bajour	French
balandra	French
banale	French
barocco	French
barricata	French
barrique	French
barré	French
bas-bleu	French
battage	French
bebè	French
berlina	French
besciamella	French
beton	French
bezoar	French
biberon	French
bicicletta	French
biciclo	French
bidone	French
bidonville	French
biella	French
biglia	French
bignè	French
bikini	French
biliardo	French
biot	French
biplano	French
biscuit	French
bisque	French
bistro	French
bistrot	French
bisturi	French
bitta	French
bivacco	French
blaga	French
blague	French
blinda	French
blindare	French
bloc-notes	French
bloccaggio	French
bloccare	French
blocco	French
blonda	French
blu	French
blusa	French
bobina	French
bohémien	French
boma	French
bombarda	French
bombare	French
bon ton	French
bonomia	French
bordeaux	French
bordura	French
bottiglia	French
boulevard	French
boutade	French
boutique	French
boxer	French
boxeur	French
bozza	French
brando	French
brelocco	French
bretella	French
brevetto	French
brioche	French
brioscia	French
broccia	French
bromo	French
brulé	French
Bruxelles	French
bucaniere	French
buffet	French
bugia	French
bullone	French
burocrate	French
buvette	French
cabaret	French
caberù	French
cabina	French
cabriolet	French
cache-col	French
cachemire	French
cachet	French
caffettiera	French
café-chantant	French
calabassa	French
calco	French
calesse	French
calorico	French
calorifero	French
calotta	French
cambra	French
camion	French
canapè	French
canard	French
cantoniere	French
capote	French
carabina	French
caramello	French
carapace	French
carenare	French
carillon	French
carlina	French
casciolongo	French
caserma	French
casinò	French
catalano	French
caucciù	French
causerie	French
causeur	French
causeuse	French
cellofan	French
cerniera	French
chaise longue	French
chalet	French
champagne	French
champignon	French
chance	French
charme	French
chef	French
choc	French
Chopin	French
chuchotage	French
châssis	French
ciambellano	French
cineasta	French
cinema	French
ciniglia	French
citronella	French
ciurmare	French
civet di capriolo	French
claque	French
claqueur	French
clementina	French
cliché	French
climaticida	French
climatico	French
clinica	French
clochard	French
cloche	French
clou	French
coalizione	French
coalizzare	French
cocaina	French
coguaro	French
colare	French
colbacco	French
collant	French
collier	French
colza	French
combine	French
combustibile	French
complotto	French
comunismo	French
comunista	French
concentrare	French
confittura	French
console	French
consommé	French
constatare	French
contabile	French
contenzione	French
controllare	French
controllo	French
coque	French
cordiale	French
cormorano	French
cornamusa	French
coscritto	French
cotoletta	French
cotta	French
coup de foudre	French
coupé	French
cravache	French
cravascia	French
crema	French
cretino	French
cric	French
crogiolo	French
croissant	French
cronometrare	French
cru	French
crépon	French
cuccia	French
cucciare	French
curbascio	French
d'emblée	French
dama	French
danza	French
dardo	French
deboscia	French
debosciato	French
debuttare	French
debutto	French
decalcare	French
decalcomania	French
decollare	French
decoro	French
defecare	French
delavé	French
deleterio	French
demi-sec	French
demoralizzare	French
demoralizzazione	French
depliant	French
deportare	French
derapare	French
deriva	French
derivare	French
derubare	French
destinatario	French
destituire	French
dettagliare	French
diabolo	French
diopside	French
disfattismo	French
disfattista	French
disidratare	French
disidratazione	French
dispositivo	French
dissecare	French
dogo	French
domino	French
domo	French
dongione	French
dossier	French
dragare	French
draglia	French
dragona	French
drakar	French
drenare	French
drongo	French
drusa	French
débauche	French
débrayage	French
décolleté	French
défaillance	French
défilé	French
démaquillage	French
démodé	French
dépliant	French
eccedentario	French
eclatante	French
editare	French
edredone	French
edulcorare	French
egalitario	French
egalitarismo	French
egualitario	French
egualitarismo	French
egualizzare	French
elettrodinamico	French
elicottero	French
elitario	French
ematosi	French
emazia	French
embrassons-nous	French
emulsione	French
emù	French
endemico	French
enfant prodige	French
entourage	French
entraineuse	French
entremets	French
epurare	French
equipaggio	French
escamotage	French
esistenzialismo	French
esplosivo	French
est	French
etichetta	French
expertise	French
exploit	French
faglia	French
farcia	French
fard	French
farsa	French
fauvismo	French
federativo	French
fennec	French
ferma	French
fermaglio	French
feticcio	French
feuilleton	French
fiacre	French
fiche	French
fideismo	French
fideista	French
filibustiere	French
filiera	French
filtro	French
fissatore	French
flammé	French
flanella	French
flotta	French
flottare	French
flûte	French
fonetico	French
footing	French
forfait	French
forgia	French
forgiare	French
formico	French
Foucault	French
foulard	French
frac	French
franco	French
frangia	French
fresa	French
fresare	French
fricativo	French
frigidaire	French
frigoria	French
frisare	French
fronda	French
fumoir	French
funzionare	French
furbo	French
furgone	French
furiere	French
fusa	French
gabardine	French
gabinetto	French
galletta	French
gallonare	French
gallone	French
galoche	French
galop	French
gamella	French
garage	French
garanzia	French
gargouille	French
gariga	French
garza	French
garzone	French
garçonnière	French
gastronomia	French
gattina	French
gauchisme	French
gauchiste	French
gaufre	French
genare	French
gendarme	French
gettone	French
ghignare	French
ghimberga	French
ghindazzo	French
ghisa	French
giaco	French
giada	French
giansenismo	French
giansenista	French
Giappone	French
giardinaggio	French
giardiniere	French
giardino	French
giavellotto	French
gibassiera	French
gilda	French
gillotaggio	French
gilè	French
giuria	French
giurì	French
giustapposizione	French
glassa	French
glassare	French
glifo	French
glissare	French
gloriette	French
glottale	French
gnu	French
goffrare	French
goletta	French
gorgia	French
gourmet	French
granazzo	French
granguignolesco	French
griffe	French
griglia	French
grisaglia	French
grisaille	French
gros-grain	French
guarnigione	French
guêpière	French
habitué	French
henné	French
horeca	French
hotel	French
idratare	French
imballare	French
imbarcadero	French
imbutire	French
impasse	French
impilare	French
importare	French
imprevisibile	French
impromptu	French
incolore	French
infantare	French
ingaggiare	French
ingobbio	French
ingranare	French
innocentare	French
inox	French
insembre	French
intendente	French
intermediario	French
intravedere	French
invergare	French
ironista	French
Jean	French
Jeanne	French
jeu de massacre	French
jeune fille	French
joule	French
julienne	French
L'Aia	French
lama	French
lamasseria	French
lampista	French
lapin	French
lattosio	French
legalizzare	French
legalizzazione	French
legiferare	French
levriero	French
Lilla	French
lingerie	French
lingio	French
lingottiera	French
linguista	French
Lione	French
lipide	French
liseuse	French
livarda	French
Londra	French
losanga	French
lucchetto	French
lunello	French
macabro	French
macla	French
macro	French
maggioritario	French
maitresse	French
maki	French
Malebranche	French
malico	French
mammalucco	French
manometria	French
manometro	French
maquillage	French
marciare	French
margarina	French
mariolo	French
marmotta	French
marna	French
marron glacé	French
mascheretto	French
massacrare	French
massacro	French
massaggio	French
medagliare	French
menu	French
merovingio	French
mersì	French
mersì bocù	French
messaggero	French
metella	French
metrò	French
metró	French
microfiche	French
mignon	French
mignone	French
mignotta	French
miliardo	French
miluogo	French
mimare	French
minoritario	French
mirabolano	French
mirabolante	French
miraggio	French
missaggio	French
missare	French
mistificare	French
mitena	French
mitomane	French
mitraglia	French
mitragliare	French
Mitterrand	French
mixage	French
mixare	French
mohair	French
moire	French
montare	French
montblanc	French
Moreau	French
morganatico	French
moriglione	French
musmè	French
muta	French
mèche	French
mélo	French
nappare	French
narghilè	French
naïf	French
neerlandese	French
neologico	French
noblesse oblige	French
nord	French
nécessaire	French
négligé	French
oblò	French
Oceania	French
ocelot	French
oculista	French
oculistica	French
odalisca	French
oficleide	French
ogivale	French
olefiante	French
omelette	French
organdis	French
oriolo	French
ossalico	French
ossido	French
ossigenare	French
ossigeno	French
osé	French
ouverture	French
ovatta	French
ovest	French
ozono	French
pachiderma	French
pacifista	French
pagaia	French
paillette	French
Palestina	French
palmares	French
paltò	French
pamphlet	French
panache	French
panda	French
paniera	French
paniere	French
panne	French
pantalone	French
papier collé	French
paraggio	French
parcella	French
pardessous	French
pariglia	French
parpagliola	French
parquet	French
parure	French
parvenu	French
passe-partout	French
passerella	French
pasteca	French
pata	French
patafisica	French
patois	French
patron	French
patta	French
pattinare	French
pattino	French
paté	French
Paul	French
pedalò	French
pederasta	French
peluche	French
pendant	French
percalle	French
periglio	French
perla	French
Perpignano	French
personaggio	French
petaccio	French
petit-gris	French
peziolo	French
physique du rôle	French
piaffare	French
piattaforma	French
piccare	French
picchetto	French
picco	French
picnic	French
pied-de-poule	French
pimento	French
pinguino	French
pinza	French
piovra	French
piroetta	French
piroga	French
pistard	French
pistola	French
plafond	French
plaquette	French
pochade	French
pois	French
polisemia	French
Pompidou	French
porte-enfant	French
pralina	French
profiterole	French
progettare	French
progetto	French
propulsivo	French
psiche	French
puddinga	French
purè	French
quai	French
quartiere	French
quenelle	French
querelle	French
quietanza	French
quietudine	French
racchetta	French
racla	French
rada	French
radiare	French
radio	French
ragù	French
ralinga	French
ralingare	French
ramberga	French
rango	French
ratafià	French
ratina	French
razzia	French
reclame	French
refrain	French
relais	French
relegazione	French
renetta	French
reportage	French
responsabile	French
retentire	French
ribadocchino	French
Rimbaud	French
risorsa	French
ritorno	French
Robert	French
robot	French
rocaille	French
rocambola	French
rocambolesco	French
roccaglia	French
rococò	French
rollare	French
rondella	French
rosé	French
roulette	French
roulotte	French
routine	French
rubinetto	French
ruche	French
rullare	French
rétro	French
sabotaggio	French
sabotare	French
sagrì	French
sakè	French
sala	French
salmì	French
salopette	French
salvaguardare	French
sapotiglia	French
sargasso	French
sariga	French
savoir-faire	French
savoir-vivre	French
sbrecciare	French
scaloppa	French
scartare	French
sciacallo	French
scialle	French
sciarpa	French
scientismo	French
scientista	French
scimpanzé	French
scolare	French
se la vì	French
Segre	French
segregare	French
semaforo	French
semantica	French
senna	French
silfide	French
sistematica	French
sistematico	French
slip	French
smoking	French
sondaggio	French
sondare	French
sorpassare	French
sorta	French
sortire	French
sorvegliare	French
soubrette	French
soufflé	French
souplesse	French
sous-chef	French
souvenir	French
stage	French
stallare	French
stero	French
stetoscopio	French
stile	French
stonare	French
succursale	French
sud	French
supportare	French
supporto	French
surmenage	French
surplace	French
surplus	French
tabarin	French
tailleur	French
talegalla	French
taloscia	French
tangone	French
tapis roulant	French
tartufo	French
tatuaggio	French
teleferico	French
tentacolare	French
teodicea	French
terrazza	French
TIR	French
tiragliere	French
tocco	French
tofo	French
toilette	French
tonneau	French
topinambur	French
torba	French
torbiera	French
tormalina	French
torrenziale	French
toupet	French
Tour de France	French
tournée	French
tout court	French
traglia	French
tranchant	French
tranciare	French
transfert	French
transumanza	French
transumare	French
trappista	French
trasmissibile	French
treno	French
tricot	French
trompe l'oeil	French
troupe	French
truccare	French
trumeau	French
truppa	French
turbina	French
turbine	French
turismo	French
turista	French
turno	French
tzigano	French
tè	French
ugualitario	French
ugualitarismo	French
usura	French
usuriere	French
uì	French
vacanza	French
vagone	French
vallone	French
vampiro	French
vantaggio	French
varietà	French
Vaucluse	French
velocipede	French
ventaglio	French
vermiglio	French
vernissage	French
versare	French
verve	French
vetrofania	French
Vichy	French
vignetta	French
villanelle	French
vivanda	French
viveur	French
voile	French
vol-au-vent	French
volant	French
voliera	French
zambra	French
zebù	French
zigano	French
zuavo	French
à la page	French
éclair	French
écru	French
élite	French
épagneul	French
étoile	French
album	German
allergia	German
alt	German
azione	German
benzina	German
birra	German
boxer	German
brindisi	German
buccia	German
calesse	German
Carso	German
cartello	German
cioncare	German
converbo	German
crauti	German
cren	German
Danzica	German
Dusseldorf	German
enzima	German
Enzo	German
finferlo	German
fisicoteologia	German
fon	German
föhn	German
ganga	German
geoide	German
Goldstein	German
Hauschild	German
hinterland	German
idrante	German
Ingrid	German
Interlaken	German
Joel	German
kaputt	German
kapò	German
kinderheim	German
kitsch	German
Kohl	German
krapfen	German
kursaal	German
Königsberg	German
laccamuffa	German
lanzichenecco	German
lavina	German
leitmotiv	German
Magdeburgo	German
mansfelto	German
masochismo	German
Michael	German
mole	German
Mozart	German
nisba	German
obice	German
orneblenda	German
ostpolitik	German
panenteismo	German
paritetico	German
Paul	German
Peter	German
pirrolo	German
quantum	German
Roth	German
salbanda	German
scellino	German
scevà	German
schei	German
Schild	German
schwa	German
semel	German
sleppa	German
slivoviz	German
spato	German
speck	German
Stasi	German
strudel	German
Svizzera	German
ussaro	German
Walter	German
Weiss	German
wolframio	German
Worms	German
würstel	German
zarina	German
zircone	German
alef	Hebrew
chippa	Hebrew
fasullo	Hebrew
goi	Hebrew
inghippo	Hebrew
kaf	Hebrew
kinnor	Hebrew
Knesset	Hebrew
lamed	Hebrew
Nimrod	Hebrew
sabra	Hebrew
taccagno	Hebrew
Uriele	Hebrew
arigatò	Japanese
asebo	Japanese
cachi	Japanese
catana	Japanese
dorayaki	Japanese
Edo	Japanese
emoji	Japanese
haiku	Japanese
Honda	Japanese
kabuki	Japanese
kamikaze	Japanese
katana	Japanese
katsuobushi	Japanese
maki	Japanese
manga	Japanese
matcha	Japanese
miso	Japanese
miyagawa	Japanese
Monte Fuji	Japanese
Mori	Japanese
namelaka	Japanese
no	Japanese
obi	Japanese
onigiri	Japanese
onsen	Japanese
origami	Japanese
Osaka	Japanese
otaku	Japanese
ramen	Japanese
samurai	Japanese
sashimi	Japanese
satsuma	Japanese
shiatsu	Japanese
shogun	Japanese
sodoku	Japanese
sumo	Japanese
surimi	Japanese
sushi	Japanese
tempura	Japanese
tenno	Japanese
Tokyo	Japanese
torii	Japanese
tsunami	Japanese
udon	Japanese
arancia	Sanskrit
arancio	Sanskrit
chador	Sanskrit
devanagari	Sanskrit
dharma	Sanskrit
karma	Sanskrit
linga	Sanskrit
lingam	Sanskrit
naga	Sanskrit
nirvana	Sanskrit
pali	Sanskrit
raga	Sanskrit
svastica	Sanskrit
tantra	Sanskrit
agit-prop	Russian
apparatcik	Russian
Boris	Russian
Brezhnev	Russian
Brežnev	Russian
Cernobyl	Russian
Chajkovski	Russian
Chernobyl	Russian
Chruščëv	Russian
cosmonauta	Russian
Dostoevskij	Russian
Dudaev	Russian
Eltsin	Russian
Fedora	Russian
Gorbacev	Russian
Gorbaciov	Russian
iacuto	Russian
Inguscezia	Russian
isba	Russian
Karpov	Russian
Kasparov	Russian
katiuscia	Russian
Khruscëv	Russian
kombinat	Russian
Kruscev	Russian
kulak	Russian
kulan	Russian
ladia	Russian
Lenin	Russian
menscevico	Russian
Mosca	Russian
Moscovia	Russian
Musorgskij	Russian
Nadia	Russian
nomenklatura	Russian
Pasternak	Russian
perestrojka	Russian
pope	Russian
presidium	Russian
Prokof'ev	Russian
Prokofev	Russian
Prokofiev	Russian
Prokofjev	Russian
Rachmaninoff	Russian
Rachmaninov	Russian
rasputizsa	Russian
rublo	Russian
sagena	Russian
Shostakovich	Russian
Solgenitsyn	Russian
Solzenicyn	Russian
Solženicyn	Russian
Soči	Russian
Stalin	Russian
stiliaga	Russian
Stravinskij	Russian
Togliatti	Russian
Tolstoj	Russian
udmurto	Russian
uniate	Russian
vodka	Russian
votiaco	Russian
zar	Russian
zarevic	Russian
Zemfira	Russian
Čajkovskij	Russian
Šostakovič	Russian
bey	Turkish
bricco	Turkish
caffè	Turkish
caicco	Turkish
caravanserraglio	Turkish
chiosco	Turkish
dey	Turkish
giannizzero	Turkish
guebro	Turkish
Gugerat	Turkish
harem	Turkish
iradè	Turkish
lokum	Turkish
mavì	Turkish
minareto	Turkish
pascià	Turkish
sceriat	Turkish
sorbetto	Turkish
turbante	Turkish
yogurt	Turkish
zamberlucco	Turkish
zaptiè	Turkish