abaton	Ancient Greek
Acaia	Ancient Greek
acrotério	Ancient Greek
actino-	Ancient Greek
acónito	Ancient Greek
acústico	Ancient Greek
adélfico	Ancient Greek
aero-	Ancient Greek
afasia	Ancient Greek
afonia	Ancient Greek
Afrodite	Ancient Greek
Afrodito	Ancient Greek
Aglaia	Ancient Greek
agnosia	Ancient Greek
agonizar	Ancient Greek
agonístico	Ancient Greek
agrónomo	Ancient Greek
Alecto	Ancient Greek
alisso	Ancient Greek
alo-	Ancient Greek
amnésia	Ancient Greek
amorfo	Ancient Greek
anacoluto	Ancient Greek
anadema	Ancient Greek
Ananke	Ancient Greek
anarquia	Ancient Greek
andro-	Ancient Greek
anemo-	Ancient Greek
aneurisma	Ancient Greek
anfictionia	Ancient Greek
anficélico	Ancient Greek
anfitrião	Ancient Greek
angiosperma	Ancient Greek
anorexia	Ancient Greek
antela	Ancient Greek
anti-	Ancient Greek
antilógico	Ancient Greek
antimetábole	Ancient Greek
antipatia	Ancient Greek
antiptose	Ancient Greek
antissigma	Ancient Greek
antitético	Ancient Greek
anto-	Ancient Greek
antologia	Ancient Greek
antropo-	Ancient Greek
antístrofe	Ancient Greek
antítipo	Ancient Greek
anábase	Ancient Greek
anáfora	Ancient Greek
anástrofe	Ancient Greek
aorta	Ancient Greek
apneia	Ancient Greek
apocatástase	Ancient Greek
arcaico	Ancient Greek
Aristóteles	Ancient Greek
artro-	Ancient Greek
astato	Ancient Greek
astenia	Ancient Greek
asteroide	Ancient Greek
atlas	Ancient Greek
atmo-	Ancient Greek
aulo	Ancient Greek
autarquia	Ancient Greek
auto-	Ancient Greek
autômato	Ancient Greek
axiomático	Ancient Greek
berilo	Ancient Greek
beta	Ancient Greek
bio-	Ancient Greek
Bizâncio	Ancient Greek
braquia	Ancient Greek
cacofonia	Ancient Greek
caligráfico	Ancient Greek
camelo	Ancient Greek
Canaã	Ancient Greek
cardio-	Ancient Greek
Caronte	Ancient Greek
carpo	Ancient Greek
carpófago	Ancient Greek
catarse	Ancient Greek
categoria	Ancient Greek
catálise	Ancient Greek
catástrofe	Ancient Greek
cipriota	Ancient Greek
clasmocitose	Ancient Greek
clínico	Ancient Greek
clítoris	Ancient Greek
coma	Ancient Greek
Constantinopla	Ancient Greek
corográfico	Ancient Greek
cosmopolita	Ancient Greek
cripto-	Ancient Greek
cromo	Ancient Greek
cromo-	Ancient Greek
crono-	Ancient Greek
cronológico	Ancient Greek
Cronos	Ancient Greek
Cólofon	Ancient Greek
cónico	Ancient Greek
delta	Ancient Greek
demagogo	Ancient Greek
demagógico	Ancient Greek
democracia	Ancient Greek
democrático	Ancient Greek
di-	Ancient Greek
didático	Ancient Greek
dinastia	Ancient Greek
dinâmico	Ancient Greek
dispraxia	Ancient Greek
diácope	Ancient Greek
diérese	Ancient Greek
Diógenes	Ancient Greek
dióspiro	Ancient Greek
dêixis	Ancient Greek
eclésia	Ancient Greek
eczema	Ancient Greek
ecônomo	Ancient Greek
endo-	Ancient Greek
endorreico	Ancient Greek
enfático	Ancient Greek
eno-	Ancient Greek
entomo-	Ancient Greek
eoo	Ancient Greek
Eos	Ancient Greek
epidídimo	Ancient Greek
epopeia	Ancient Greek
epígrafe	Ancient Greek
epílogo	Ancient Greek
equimose	Ancient Greek
Eratóstenes	Ancient Greek
ergo	Ancient Greek
Eros	Ancient Greek
esfenoide	Ancient Greek
esotérico	Ancient Greek
esqueleto	Ancient Greek
estoma	Ancient Greek
estratégia	Ancient Greek
estética	Ancient Greek
estético	Ancient Greek
etmoide	Ancient Greek
etno-	Ancient Greek
Euclides	Ancient Greek
euforia	Ancient Greek
eufônio	Ancient Greek
Eunápio	Ancient Greek
eupátrida	Ancient Greek
eureca	Ancient Greek
exegeta	Ancient Greek
exo-	Ancient Greek
exorreico	Ancient Greek
extático	Ancient Greek
fase	Ancient Greek
filargíria	Ancient Greek
Filomena	Ancient Greek
filáucia	Ancient Greek
fito-	Ancient Greek
Florianópolis	Ancient Greek
fonema	Ancient Greek
fono-	Ancient Greek
foto-	Ancient Greek
gama	Ancient Greek
gameta	Ancient Greek
geo-	Ancient Greek
gnose	Ancient Greek
grama	Ancient Greek
Génesis	Ancient Greek
halo-	Ancient Greek
haltere	Ancient Greek
Hefesto	Ancient Greek
hemi-	Ancient Greek
Hera	Ancient Greek
Hermes	Ancient Greek
hioide	Ancient Greek
hiper-	Ancient Greek
Hipnos	Ancient Greek
hipocorístico	Ancient Greek
hipocrisia	Ancient Greek
Hipérion	Ancient Greek
hipófise	Ancient Greek
Hécate	Ancient Greek
Héstia	Ancient Greek
Ámon	Ancient Greek
átono	Ancient Greek
éon	Ancient Greek
Éris	Ancient Greek
êmese	Ancient Greek
acerola	Arabic
adarga	Arabic
adufa	Arabic
alazão	Arabic
alaúde	Arabic
albornoz	Arabic
albufeira	Arabic
alcaguete	Arabic
alcaçuz	Arabic
alcáçova	Arabic
aletria	Arabic
alfarroba	Arabic
alfinete	Arabic
alforje	Arabic
alfândega	Arabic
alicate	Arabic
aljuba	Arabic
almude	Arabic
almíscar	Arabic
alvenel	Arabic
anil	Arabic
arroz	Arabic
arrátel	Arabic
atum	Arabic
açafrão	Arabic
açucena	Arabic
celamim	Arabic
cherovia	Arabic
ginete	Arabic
javali	Arabic
limão	Arabic
maquia	Arabic
papoula	Arabic
regueifa	Arabic
zagal	Arabic
Abu Simbel	Arabic
Acaba	Arabic
acepipe	Arabic
acicate	Arabic
acém	Arabic
adarga	Arabic
adelo	Arabic
adhan	Arabic
adobe	Arabic
adufa	Arabic
adufe	Arabic
Al-Andalus	Arabic
Aladim	Arabic
alambique	Arabic
alambre	Arabic
alazão	Arabic
alaúde	Arabic
albornoz	Arabic
albufeira	Arabic
alcachofra	Arabic
Alcaida	Arabic
alcanzia	Arabic
alcaravia	Arabic
alcarraza	Arabic
alcateia	Arabic
alcatifa	Arabic
alcatraz	Arabic
alcatruz	Arabic
alcatrão	Arabic
alcaçuz	Arabic
Alcobaça	Arabic
alcunha	Arabic
alcácer	Arabic
Alcácer-Quibir	Arabic
alcáçova	Arabic
aldraba	Arabic
alecrim	Arabic
aleli	Arabic
aletria	Arabic
alface	Arabic
alfafa	Arabic
alfarroba	Arabic
alfavaca	Arabic
alfazema	Arabic
alferes	Arabic
alfinete	Arabic
alforba	Arabic
alforje	Arabic
alforria	Arabic
alfândega	Arabic
algazarra	Arabic
algema	Arabic
algibebe	Arabic
algoz	Arabic
alguidar	Arabic
alicate	Arabic
alicerce	Arabic
aljava	Arabic
almanjarra	Arabic
Almeida	Arabic
almenara	Arabic
almocreve	Arabic
almocávar	Arabic
Almodôvar	Arabic
almoeda	Arabic
almotolia	Arabic
almoxarife	Arabic
almádena	Arabic
almíscar	Arabic
alquermes	Arabic
Alvaiázere	Arabic
alvenel	Arabic
alverca	Arabic
Alverca	Arabic
alxarife	Arabic
Alá	Arabic
anil	Arabic
anta	Arabic
argola	Arabic
armazém	Arabic
arrabalde	Arabic
arrais	Arabic
arrátel	Arabic
atabaque	Arabic
Atalaia	Arabic
atalaia	Arabic
ataúde	Arabic
atum	Arabic
auge	Arabic
azenha	Arabic
azinhaga	Arabic
azorrague	Arabic
azáfama	Arabic
açafrão	Arabic
açoite	Arabic
açorda	Arabic
açoute	Arabic
açude	Arabic
açúcar	Arabic
baldar	Arabic
baniano	Arabic
baraço	Arabic
beliz	Arabic
berbere	Arabic
beringela	Arabic
botilhão	Arabic
cabaia	Arabic
Cacela	Arabic
cacife	Arabic
Cacém	Arabic
candil	Arabic
cartaz	Arabic
Catar	Arabic
ceifa	Arabic
ceroula	Arabic
ceroulas	Arabic
cetim	Arabic
chafariz	Arabic
chahada	Arabic
cherovia	Arabic
Corão	Arabic
curcuma	Arabic
cuscuz	Arabic
dinar	Arabic
Divor	Arabic
Dubai	Arabic
Eid al-Adha	Arabic
esfirra	Arabic
Fafe	Arabic
farda	Arabic
fatia	Arabic
forro	Arabic
Fátima	Arabic
fátua	Arabic
gabão	Arabic
ginete	Arabic
giz	Arabic
guitarra	Arabic
génio	Arabic
haram	Arabic
haxixe	Arabic
hádice	Arabic
Iatrebe	Arabic
Iblis	Arabic
Ibraim	Arabic
ide	Arabic
intifada	Arabic
jaez	Arabic
jarra	Arabic
javali	Arabic
jihad	Arabic
Lafões	Arabic
leilão	Arabic
limão	Arabic
mameluco	Arabic
Maomé	Arabic
marafona	Arabic
marrão	Arabic
Marvão	Arabic
masmorra	Arabic
matraca	Arabic
mesquinho	Arabic
metical	Arabic
monção	Arabic
moçárabe	Arabic
mufti	Arabic
Murça	Arabic
muslim	Arabic
Mustafá	Arabic
Mértola	Arabic
múmia	Arabic
nababo	Arabic
nicabe	Arabic
Ode-	Arabic
Odeceixe	Arabic
Odeleite	Arabic
Odelouca	Arabic
Odemira	Arabic
Odiana	Arabic
Odivelas	Arabic
Odiáxere	Arabic
Omar	Arabic
Queluz	Arabic
quilate	Arabic
recife	Arabic
resma	Arabic
Rife	Arabic
Sacavém	Arabic
safra	Arabic
salamaleque	Arabic
saloio	Arabic
Sanaa	Arabic
sardão	Arabic
sarrafo	Arabic
Setúbal	Arabic
sotaque	Arabic
Sátão	Arabic
tabefe	Arabic
tagarela	Arabic
tara	Arabic
toranja	Arabic
tremoço	Arabic
tufão	Arabic
Tunes	Arabic
tâmara	Arabic
uau	Arabic
ud	Arabic
xairel	Arabic
xareta	Arabic
xaria	Arabic
xaroco	Arabic
xarope	Arabic
Xatalárabe	Arabic
xauarma	Arabic
xeque	Arabic
xeque-mate	Arabic
xerife	Arabic
xiita	Arabic
xávega	Arabic
zarabatana	Arabic
zoina	Arabic
Angeloff	Bulgarian
Angelov	Bulgarian
Antonoff	Bulgarian
Antonov	Bulgarian
Bogdanov	Bulgarian
Dimitroff	Bulgarian
Dimitrov	Bulgarian
Draganoff	Bulgarian
Draganov	Bulgarian
Ganeff	Bulgarian
Ganev	Bulgarian
Georgieff	Bulgarian
Georgiev	Bulgarian
Hristoff	Bulgarian
Hristov	Bulgarian
Ilieff	Bulgarian
Iliev	Bulgarian
Ivanoff	Bulgarian
Ivanov	Bulgarian
Mileff	Bulgarian
Milev	Bulgarian
Nikoloff	Bulgarian
Nikolov	Bulgarian
Parvanoff	Bulgarian
Petroff	Bulgarian
Petrov	Bulgarian
Popoff	Bulgarian
Popov	Bulgarian
Prodanov	Bulgarian
Radev	Bulgarian
Rousseff	Bulgarian
Rusev	Bulgarian
Simeonoff	Bulgarian
Simeonov	Bulgarian
Stefanoff	Bulgarian
Stefanov	Bulgarian
Stojanov	Bulgarian
Stoyanov	Bulgarian
Tarnovski	Bulgarian
Todoroff	Bulgarian
Todorov	Bulgarian
avante	Catalan
avançar	Catalan
baixela	Catalan
Barcelona	Catalan
barraca	Catalan
betume	Catalan
broca	Catalan
caixa	Catalan
calamar	Catalan
capicua	Catalan
convite	Catalan
forasteiro	Catalan
gruta	Catalan
loja	Catalan
molhe	Catalan
nau	Catalan
paiol	Catalan
pincel	Catalan
pivete	Catalan
preboste	Catalan
robalo	Catalan
rubi	Catalan
salitre	Catalan
sotavento	Catalan
truco	Catalan
veludo	Catalan
vogar	Catalan
Almere	Dutch
Amesterdão	Dutch
Amsterdã	Dutch
Antuérpia	Dutch
batik	Dutch
bóer	Dutch
Devos	Dutch
dique	Dutch
dodô	Dutch
Drenthe	Dutch
escorbuto	Dutch
Flevoland	Dutch
Gelderland	Dutch
Groningen	Dutch
Leiden	Dutch
Neerlândia	Dutch
Overijssel	Dutch
pinque	Dutch
Prins	Dutch
pólder	Dutch
seringa	Dutch
Suriname	Dutch
Utrecht	Dutch
Utreque	Dutch
Vanderlei	Dutch
Windhoek	Dutch
Aberdeen	English
abort	English
ace	English
acid jazz	English
acre	English
acurácia	English
ad	English
adamantium	English
add	English
add-on	English
Adirondacks	English
adware	English
afro	English
afrobeat	English
after	English
agitprop	English
agnóstico	English
AIDS	English
air guitar	English
airbag	English
Alabama	English
alabama	English
Alan	English
Alasca	English
Alaska	English
albatroz	English
aldrin	English
aldrina	English
Alexander	English
aleúte	English
Alfredo	English
algoritmo	English
aliasing	English
Alice	English
alien	English
aligátor	English
alô	English
amerício	English
amish	English
anaconda	English
anarcocapitalista	English
Ane	English
Anglesey	English
anti-aliasing	English
anti-spyware	English
antialiasing	English
antidumping	English
antispoofing	English
Antrim	English
anão	English
aparatar	English
API	English
app	English
Appalachia	English
Apple	English
aril	English
Arizona	English
Arkansas	English
array	English
ASCII	English
assembly	English
atuário	English
Auckland	English
automação	English
avatar	English
baby boom	English
baby boomer	English
backhand	English
backspace	English
backup	English
bacon	English
badminton	English
badmínton	English
bagel	English
Bahamas	English
banana split	English
band-aid	English
bandicoot	English
bangue	English
banked slalom	English
bar	English
barman	English
barômetro	English
basquetebol	English
Batman	English
bazuca	English
beatbox	English
Beatles	English
beatnik	English
becape	English
bechuana	English
beibidol	English
beisebol	English
bend	English
benzodiazepina	English
beque	English
berquélio	English
best	English
best-seller	English
bestseller	English
Betsy	English
bia	English
bife	English
Big Bang	English
Big Ben	English
Big Mac	English
bingo	English
bisteca	English
bit	English
bitcoin	English
Black Friday	English
black metal	English
blackout	English
blecaute	English
blefe	English
blitz	English
block	English
blockbuster	English
blog	English
blogue	English
bloody mary	English
bloque	English
blues	English
Bluetooth	English
bluff	English
blush	English
bodycam	English
Boeing	English
boicote	English
Bollywood	English
bombástico	English
bonde	English
booleano	English
boom	English
boot	English
border collie	English
boss	English
Boston	English
bosónico	English
bot	English
bottom	English
bowling	English
box	English
boxers	English
boy magia	English
brada	English
brande	English
brandy	English
braquiação	English
breque	English
brick	English
bridge	English
brigue	English
Bristol	English
brownie	English
brunch	English
bróder	English
buffer	English
bug	English
buldogue	English
bulldog	English
bullying	English
bumerangue	English
bungee jump	English
bungee jumping	English
bunker	English
butilo	English
buzzword	English
bypass	English
bólingue	English
bónus	English
búnquer	English
búrguer	English
Cabo Canaveral	English
cache	English
caiaque	English
Calgary	English
Califórnia	English
Camberra	English
Cambridge	English
cameraman	English
camone	English
camper	English
camping	English
Canberra	English
canguru	English
canvas	English
capitelo	English
Cardiff	English
cardigan	English
carte	English
cartoon	English
cartune	English
catamarã	English
caubói	English
CD	English
CD player	English
celuloide	English
CEO	English
chador	English
champô	English
chan	English
channer	English
chanspeak	English
Charles	English
chat	English
cheat	English
cheater	English
checar	English
check-up	English
cheddar	English
cheerleader	English
cheeseburguer	English
cheesecake	English
cheque	English
Chevrolet	English
Chicago	English
chiclete	English
chicungunha	English
chikungunya	English
chip	English
chipe	English
chita	English
chorus	English
Christchurch	English
Christopher	English
chuinga	English
chute	English
chutney	English
chuto	English
ciber-	English
cibernética	English
ciborgue	English
ciclone	English
cientista	English
cientologia	English
Cinderela	English
civil law	English
clearance	English
clicar	English
clipe	English
clique	English
close-up	English
closet	English
closet americano	English
clube	English
cluster	English
clã	English
clérgima	English
coach	English
coala	English
cobói	English
codec	English
colina	English
combo	English
cometimento	English
comment	English
commodity	English
common law	English
comodoro	English
comódite	English
conectar	English
conector	English
Connecticut	English
console	English
contraceptivo	English
contraceção	English
control	English
contêiner	English
conurbação	English
cookie	English
cooler	English
copirraite	English
copyright	English
coque	English
coquetel	English
core	English
coronavírus	English
cosmópolis	English
cosplay	English
cotton	English
coulrofobia	English
country	English
cover	English
Covid-19	English
cowbell	English
cowboy	English
CPU	English
crack	English
crannog	English
craque	English
crau	English
crawl	English
cream cheese	English
cream cracker	English
creepypasta	English
cringe	English
Cristian	English
crol	English
crowdfunding	English
crude	English
crush	English
críquete	English
cróquete	English
cuca	English
cult	English
cultivar	English
cup noodles	English
cupcake	English
curling	English
cáqui	English
cânion	English
cúter	English
Daiane	English
darknet	English
Darwin	English
date	English
David	English
deadlock	English
Deagle	English
death metal	English
default	English
Delaware	English
delaware	English
delay	English
deletar	English
delete	English
delivery	English
demo	English
deque	English
design	English
designer	English
desktop	English
destróier	English
detectar	English
detetar	English
detetive	English
Detroit	English
developer	English
Devon	English
Dexter	English
diesel	English
diet	English
digrafo	English
dildo	English
disc jockey	English
Discord	English
display	English
disquete	English
DJ	English
DNA	English
doca	English
dodô	English
dogue	English
dola	English
donut	English
dopamina	English
dopar	English
doping	English
Douglas	English
doula	English
Dover	English
download	English
drag queen	English
drible	English
dril	English
drinque	English
drive	English
drive-in	English
drive-thru	English
driver	English
droide	English
drone	English
Dublim	English
Dublin	English
dugongo	English
dumping	English
Durban	English
durex	English
durio	English
duty-free	English
DVD	English
dáblio	English
dérbi	English
dísel	English
dólar	English
dónute	English
e-book	English
e-boy	English
e-girl	English
e-mail	English
ebola	English
Edgar	English
Edimburgo	English
eletrão	English
elfo	English
elusivo	English
Elvis	English
elétron	English
emoji	English
emoticon	English
emu	English
end zone	English
ESA	English
escuna	English
escuta	English
escâner	English
esnobe	English
espacial	English
especiação	English
esporte	English
esprei	English
espringue	English
esquete	English
establishment	English
estafe	English
estande	English
estarte	English
estepe	English
esterlino	English
estilingue	English
estique	English
estoa	English
estol	English
estoque	English
estresse	English
estúdio	English
exabit	English
exabyte	English
Excalibur	English
expert	English
exploit	English
expo	English
exposed	English
Face	English
Facebook	English
factoring	English
fake	English
fandom	English
fanfic	English
fap	English
FAQ	English
farme	English
faroeste	English
fashion	English
fast food	English
feed	English
feedback	English
femboy	English
fermiónico	English
ferry	English
filme	English
firewall	English
firmware	English
first-person shooter	English
fisting	English
fitness	English
flag	English
flamingo	English
flash card	English
flashback	English
flat	English
flate	English
flerte	English
flete	English
flip-flop	English
flood	English
flow	English
fluorescente	English
fluorescência	English
flush	English
flushing	English
flíper	English
Flórida	English
folclore	English
folder	English
folk	English
fone	English
food truck	English
for	English
Fordlandia	English
fossa	English
FPS	English
frame	English
franchise	English
franchising	English
Frank	English
freegan	English
freelancer	English
freestyle	English
freezer	English
fricativo	English
frízer	English
full house	English
fundamentalismo	English
fundamentalista	English
funk	English
futebol	English
fã	English
galão	English
gama	English
game	English
game show	English
gamer	English
gamão	English
ganga	English
gangue	English
ganza	English
gasóleo	English
gate	English
Gatling	English
gay	English
gaélico	English
geek	English
gel	English
gentrificação	English
ghostwriter	English
ghoul	English
gigabit	English
gigabyte	English
gim	English
gincana	English
glamour	English
Glasgow	English
glitter	English
gol	English
golfe	English
golo	English
Google	English
gore	English
gospel	English
green card	English
Gringolândia	English
grogue	English
guei	English
guerigueri	English
Guernsey	English
guna	English
gângster	English
góji	English
hacker	English
haddock	English
hadoque	English
haha	English
hall	English
Halloween	English
hamburger	English
Hamlet	English
hammer	English
handebol	English
handicap	English
handler	English
Hanna	English
happy hour	English
hard rock	English
hardware	English
harmónica	English
Harry	English
Harvard	English
hashtag	English
hater	English
heap	English
heavy metal	English
hentai	English
highlander	English
hijab	English
hijabe	English
hindi	English
hip hop	English
hippie	English
hipster	English
hit	English
HIV	English
hobby	English
hogshead	English
holding	English
Hollywood	English
holígane	English
home cinema	English
home office	English
home theater	English
Honolulu	English
hooligan	English
hormona	English
host	English
hostel	English
hot dog	English
house	English
hovercraft	English
HTML	English
hub	English
Hulk	English
hurra	English
hype	English
Ian	English
ianque	English
iate	English
iceberg	English
iglu	English
Illinois	English
impeachment	English
in	English
incel	English
input	English
Instagram	English
int	English
interface	English
internet	English
Internet	English
interrobang	English
Inverness	English
ioiô	English
Iorque	English
Iowa	English
ISIS	English
iéti	English
iê-iê-iê	English
jack	English
jam session	English
jarda	English
Jason	English
Java	English
jazz	English
jeans	English
Jedi	English
jet lag	English
jingle	English
jipe	English
job	English
jogging	English
Jonathan	English
Juneau	English
Jéssica	English
jóquer	English
júri	English
K2	English
Kansas	English
kart	English
Kentucky	English
kernel	English
ketchup	English
kettlebell	English
Kevin	English
kickboxing	English
kilobit	English
kilobyte	English
kilt	English
kit	English
kit gay	English
klaxon	English
knockout	English
know-how	English
KO	English
Labrador	English
lace	English
lan house	English
lanche	English
lanchonete	English
laptop	English
laser	English
laurêncio	English
layout	English
LCD	English
LED	English
leggings	English
lemming	English
leprechaun	English
LGBT	English
Libéria	English
lide	English
light	English
like	English
limerence	English
linchar	English
Lincoln	English
link	English
linoleico	English
linque	English
linóleo	English
literacia	English
literácia	English
Little Rock	English
live	English
live action	English
Liverpool	English
lobby	English
loganberry	English
login	English
lolardo	English
long neck	English
look	English
loop	English
LP	English
luge	English
Luisiana	English
luminescente	English
luminescência	English
lémingue	English
líder	English
lóbi	English
machimbombo	English
made in China	English
Maicol	English
Maicon	English
mainframe	English
maisena	English
make	English
making of	English
malte	English
malware	English
mana	English
Manchester	English
mandatório	English
mandril	English
Manitoba	English
marketing	English
marshmallow	English
Maryland	English
Massachusetts	English
media	English
meeting	English
megabit	English
megabyte	English
megapíxel	English
meme	English
merchandising	English
Merlin	English
messe	English
meta	English
metal	English
mexim	English
Miami	English
Mickey Mouse	English
micro system	English
microarray	English
microblogging	English
microchip	English
microchipe	English
microfone	English
microprocessador	English
milkshake	English
Minecraft	English
mini system	English
minibar	English
Minnesota	English
miscigenação	English
Missouri	English
mister	English
modem	English
moicano	English
monitor	English
Monte Evereste	English
Montgomery	English
motel	English
motor home	English
mountain bike	English
mouse	English
mousepad	English
muffin	English
mullet	English
mutar	English
muão	English
máster	English
média	English
médium	English
mídia	English
míldio	English
míster	English
mórmon	English
naifa	English
namespace	English
NASA	English
NATO	English
Nebrasca	English
neocon	English
neoprene	English
nerd	English
Nevada	English
New Brunswick	English
Newcastle	English
Neártico	English
nibble	English
nick	English
night	English
nocaute	English
nop	English
Nortúmbria	English
notebook	English
nugget	English
Nunavut	English
nylon	English
nómico	English
octano	English
ODE	English
OK	English
Omaha	English
online	English
Ontario	English
Ontário	English
orc	English
Otava	English
outdoor	English
outlet	English
outsourcing	English
overdose	English
overflow	English
Oxford	English
pack	English
padawan	English
paleoartista	English
Paleártico	English
pandemónio	English
panqueca	English
parca	English
parsec	English
part-time	English
partner	English
password	English
patchuli	English
pause	English
PC	English
Pearl Harbor	English
pedigree	English
pen-drive	English
Pensilvânia	English
penálti	English
performance	English
pesticida	English
pet	English
pet shop	English
petabit	English
petabyte	English
phishing	English
pica	English
picape	English
piche	English
pick-up	English
pickles	English
pickup	English
picles	English
piercing	English
Pierre	English
pijama	English
Pikachu	English
pinball	English
pingue-pongue	English
pink	English
pint	English
pinta	English
pinto	English
pipe	English
pipeline	English
pixel	English
pião	English
play-off	English
playback	English
playboy	English
player	English
playground	English
playlist	English
playoff	English
PlayStation	English
plotar	English
podcast	English
point	English
pointer	English
poliéster	English
polo	English
pomelo	English
ponche	English
poodle	English
pop	English
pop-up	English
portefólio	English
portfólio	English
Portsmouth	English
post	English
post-it	English
powerpoint	English
pressurizar	English
print	English
probiótico	English
propano	English
propila	English
propilo	English
proxy	English
proxy server	English
pudim	English
pull	English
pulsar	English
pulôver	English
punk	English
puzzle	English
pênalti	English
píer	English
pírcingue	English
píxel	English
pónei	English
póquer	English
póster	English
pôquer	English
pôster	English
quacre	English
quark	English
Queensland	English
quelatar	English
queque	English
Querala	English
quisling	English
quitinete	English
quivi	English
quiz	English
rail shooter	English
rali	English
rand	English
randomizar	English
ranking	English
rap	English
raptor	English
rating	English
rave	English
reality	English
reality show	English
reator	English
reboot	English
recorde	English
Reddit	English
refill	English
refletor	English
reggae	English
remake	English
remasterizar	English
remix	English
repórter	English
res	English
reset	English
resort	English
retuitar	English
revólver	English
rifle	English
rifte	English
ril	English
ring	English
ringtone	English
ringue	English
rinque	English
ripar	English
RNA	English
rock	English
rock and roll	English
rollerblade	English
Ronaldo	English
root	English
root beer	English
roque	English
round	English
royal flush	English
rugby	English
rácio	English
ráquer	English
râguebi	English
safári	English
saite	English
sanduíche	English
sarin	English
Saskatchewan	English
Saskatoon	English
save	English
scanner	English
scat	English
schnapps	English
schwa	English
Scrabble	English
scrapie	English
screencast	English
screenshot	English
script	English
scâner	English
sedã	English
seletar	English
self-service	English
selfie	English
serial killer	English
serifa	English
set	English
sex shop	English
sex symbol	English
sexy	English
shaitan	English
shampoo	English
Sheila	English
ship	English
short	English
shorts	English
shot	English
show	English
showbiz	English
showbusiness	English
sidearm	English
silte	English
single	English
sinistralidade	English
sinuca	English
sinó	English
sistémico	English
sitcom	English
site	English
skate	English
skeleton	English
sketch	English
skinhead	English
skyline	English
slide	English
slogan	English
slot machine	English
smartphone	English
smartwatch	English
smash	English
smiley	English
smog	English
SMS	English
sniper	English
snorkel	English
snowboard	English
snowmobile	English
socialite	English
Socorro	English
softball	English
software	English
sol	English
sonar	English
Sony	English
soquete	English
soul	English
sousafone	English
spa	English
spam	English
spin	English
spin-off	English
splash	English
spoiler	English
spray	English
spread	English
sprint	English
sprinter	English
sprínter	English
spyware	English
squash	English
St. George's	English
stack	English
stafe	English
staff	English
stand	English
startup	English
States	English
stique	English
Stonehenge	English
stop	English
storytelling	English
straight	English
straight flush	English
streaming	English
stresse	English
strike	English
string	English
strip	English
striptease	English
strogonoff	English
style	English
suaíli	English
subwoofer	English
Superman	English
supernova	English
surf	English
suspense	English
suéter	English
Swansea	English
sweep	English
swell	English
swing	English
switch	English
Sydney	English
Sídnei	English
t-shirt	English
tablet	English
tabloide	English
tag	English
Taiwan	English
tala	English
Tamil Nadu	English
tanque	English
tatá	English
TBT	English
teaser	English
telefone	English
telemarketing	English
teleportar	English
temperamental	English
terabit	English
terabyte	English
terrier	English
test drive	English
teste	English
Tetris	English
Texas	English
the book is on the table	English
think tank	English
thrash metal	English
thread	English
thumbnail	English
ticket	English
time	English
timer	English
timing	English
tiquê	English
Titanic	English
toner	English
Tony	English
toolbox	English
toolkit	English
top	English
topless	English
Tor	English
Toronto	English
totem	English
touch	English
trailer	English
trance	English
transponder	English
transístor	English
trap	English
trator	English
trem	English
trol	English
trole	English
troll	English
trêiler	English
tuitar	English
tuk-tuk	English
tunar	English
tuning	English
tupperware	English
tuque-tuque	English
turismo	English
tuíte	English
tweet	English
twist	English
txapo-txapo	English
táxi	English
ténis	English
tênis	English
tílburi	English
tíquete	English
tótil	English
túnel	English
uapiti	English
uau	English
uculele	English
UEFA	English
UFO	English
ukelele	English
ukulele	English
Uluru	English
underline	English
UNESCO	English
unissex	English
update	English
upgrade	English
upload	English
uquelele	English
username	English
Utah	English
uzi	English
uísque	English
van	English
Vancouver	English
VAR	English
veganismo	English
vegano	English
very light	English
very-light	English
vibe	English
video game	English
view	English
viking	English
Virgínia	English
vlog	English
vlogger	English
voleibol	English
volt	English
voucher	English
vuvuzela	English
vã	English
vérsus	English
vídeo	English
víquingue	English
vólei	English
wafer	English
waffle	English
waifu	English
walkie-talkie	English
walkman	English
WAN	English
Washington	English
watt	English
WC	English
web	English
web-	English
webcam	English
webconferência	English
website	English
Wellington	English
WhatsApp	English
whatsapp	English
whisky	English
wi-fi	English
wiki	English
William	English
wireless	English
Wisconsin	English
wishful thinking	English
workaholic	English
workshop	English
workstation	English
worm	English
Wyoming	English
X burguer	English
x-ato	English
xampu	English
Xangri-lá	English
xelim	English
xepa	English
xerife	English
xerox	English
xerpa	English
xis	English
xisbúrguer	English
xite	English
xixa	English
yield	English
yorkshire	English
yotta-	English
yottabit	English
yottabyte	English
youtuber	English
Yukon	English
yuppie	English
zapping	English
zettabit	English
zettabyte	English
Zimbabué	English
Zimbabwe	English
zombie	English
zoom	English
zumbi	English
zíper	English
áudio	English
ébola	English
ético	English
êxtase	English
Óliver	English
A Corunha	French
abajur	French
abandonar	French
Abbeville	French
Abelardo	French
Abomey	French
abordagem	French
abordar	French
abrasivo	French
abricó	French
absinto	French
absolutismo	French
abulia	French
acetato	French
acetileno	French
acionar	French
acoplar	French
acorde	French
acordeão	French
actínia	French
actínio	French
Acádia	French
acústica	French
adenite	French
adenoide	French
adenoma	French
adotivo	French
aeronauta	French
aeronáutico	French
aeroplano	French
aerossol	French
aeródino	French
afilar	French
aflitivo	French
agami	French
agiotagem	French
agir	French
agrafo	French
agência	French
aileron	French
ailerão	French
Ain	French
alarmar	French
alarme	French
alavantú	French
albatroz	French
Albertville	French
alergia	French
alevino	French
aliança	French
alienista	French
alijar	French
Aline	French
aloquete	French
alpinismo	French
alpinista	French
alquequenje	French
altruísta	French
alumínio	French
amarelinha	French
amarrar	French
Amaury	French
amblíope	French
ambulância	French
amerissagem	French
amonite	French
ampere	French
analista	French
anarriê	French
Ancien Régime	French
ancien régime	French
Ane	French
Angers	French
Angoumois	French
anis	French
Anjou	French
Anjouan	French
anoftalmia	French
anormal	French
anspeçada	French
antipodismo	French
antipodista	French
apetite	French
aplomb	French
arauto	French
arcabuz	French
arcobotante	French
ardósia	French
argot	French
Argélia	French
Ariège	French
Armagnac	French
arranjar	French
arrivista	French
art nouveau	French
artesanato	French
artesão	French
artilharia	French
assembleia	French
astronauta	French
astronáutica	French
atelier	French
ateliê	French
aterrissar	French
ateísmo	French
atitude	French
atrabile	French
au pair	French
auroque	French
auteur	French
autocolante	French
autonomia	French
autónomo	French
aval	French
avalanche	French
avatar	French
avec	French
aviador	French
Avinhão	French
avioneta	French
avião	French
Azerbaijão	French
azoto	French
azur	French
bacamarte	French
bacará	French
bagagem	French
baguete	French
baioneta	French
bala	French
balada	French
balancé	French
balancê	French
balão	French
balé	French
balê	French
bambara	French
banda	French
banquete	French
banquisa	French
barbeta	French
barbete	French
barragem	French
barrete	French
barricada	French
Barroco	French
barômetro	French
basilar	French
bassê	French
Bastilha	French
batalhão	French
bateria	French
batom	French
bebé	French
bebê	French
beduíno	French
bege	French
Beirute	French
beque	French
berdache	French
berlina	French
berlinda	French
berma	French
berço	French
beterraba	French
betão	French
bibelô	French
biberão	French
bibliografia	French
bicicleta	French
bidão	French
bidé	French
bidê	French
bilha	French
bilhar	French
bilhete	French
bilhão	French
bilião	French
biltre	French
biográfico	French
birô	French
bistrô	French
bisturi	French
bizarro	French
biótico	French
Blanchard	French
blindagem	French
blindar	French
blusa	French
boate	French
bobina	French
boiardo	French
Bois-le-Duc	French
boleia	French
bombom	French
boné	French
borda	French
bordel	French
borderô	French
bordura	French
bordô	French
bossa	French
botelha	French
botica	French
botina	French
Boucher	French
bouquet	French
boutique	French
boxeur	French
bracelete	French
brasão	French
brecha	French
brema	French
Brest	French
brevete	French
brevê	French
bricabraque	French
brida	French
brigada	French
brigadeiro	French
brinde	French
brioche	French
brique	French
briquete	French
brocha	French
broche	French
bronze	French
Bruges	French
Bruxelas	French
bubão	French
bubónico	French
bufete	French
buffet	French
bufê	French
bujarda	French
bujão	French
bulevar	French
buquê	French
bureta	French
burguesia	French
butique	French
báscula	French
Bélgica	French
bê-á-bá	French
bólide	French
cabala	French
cabaré	French
cabina	French
cabriola	French
cabriolé	French
cachar	French
cachecol	French
cachepô	French
cachê	French
cadastro	French
cadete	French
café	French
Calais	French
calandra	French
calcinar	French
caligrafia	French
calorimétrico	French
calota	French
calote	French
Calvados	French
camal	French
camelô	French
caminhão	French
camioneta	French
camião	French
Canadá	French
canapé	French
canaque	French
canard	French
cancã	French
caniche	French
cantina	French
cantão	French
capitalismo	French
caporal	French
capota	French
capote	French
capô	French
carapaça	French
caravançará	French
carbono	French
carburação	French
carcaça	French
cardiografia	French
cardiologia	French
carnê	French
carpete	French
carrilhão	French
carroceria	French
carrossel	French
carroçaria	French
cartel	French
cartucho	French
casimira	French
casquete	French
cassete	French
cassetete	French
cassino	French
cave	French
caviar	French
caçarola	French
cefaleia	French
CERN	French
chaise longue	French
chalota	French
chalupa	French
chalé	French
chaminé	French
champagne	French
champanhe	French
champignon	French
chance	French
changê	French
chanson	French
chantagem	French
chantili	French
chapa	French
charada	French
charge	French
Charles	French
charneira	French
charrete	French
charrua	French
chassi	French
chassis	French
checo	French
chef	French
chefe	French
chicana	French
chicote	French
chiffon	French
chimpanzé	French
Chipre	French
chique	French
chofer	French
chope	French
choque	French
chuchu	French
chucrute	French
ciclista	French
ciclomotor	French
cineasta	French
cinema	French
cistre	French
civeta	French
civilização	French
claque	French
claraboia	French
clichê	French
climatizar	French
climatérico	French
climático	French
clique	French
clorose	French
coalizão	French
cobarde	French
cocaína	French
cocota	French
codificar	French
cofiar	French
cofre	French
coincidir	French
colagénio	French
colchete	French
colete	French
colibri	French
colina	French
collant	French
collants	French
colza	French
colã	French
colãs	French
comandar	French
comboio	French
combustível	French
comissário	French
comité	French
comitê	French
compasso	French
compatível	French
complô	French
compostagem	French
compota	French
compressa	French
comprometer	French
concierge	French
conduíte	French
confeccionar	French
confeito	French
conhaque	French
consola	French
consommé	French
consomé	French
consomê	French
constatar	French
contestatário	French
contradança	French
controlar	French
controlo	French
coque	French
coqueluche	French
coquete	French
coquilha	French
Corbélia	French
cordão	French
corifeu	French
corrosão	French
cortesão	French
coruchéu	French
corveta	French
cossaco	French
cotão	French
coulomb	French
coxim	French
crachá	French
cravo	French
creche	French
creme	French
crepe	French
cretino	French
crime	French
croassã	French
crocante	French
crochet	French
croché	French
crochê	French
croissant	French
croquete	French
croqui	French
croquis	French
crossa	French
crème brûlée	French
cupão	French
curgete	French
cuvete	French
céptico	French
cético	French
Daillencourt	French
dama	French
damão	French
dardo	French
dauphin	French
debate	French
deboche	French
decadência	French
decalcar	French
decalque	French
decolagem	French
decolar	French
decímetro	French
defensivo	French
degradê	French
deletério	French
demagógico	French
democratizar	French
demodê	French
departamento	French
departir	French
deriva	French
derrapar	French
desconstruir	French
descritível	French
desertar	French
despautério	French
detalhar	French
detalhe	French
diabolô	French
diapasão	French
diatribe	French
diploide	French
diplomacia	French
diplomata	French
diretiva	French
distintivo	French
divinatório	French
divã	French
diábolo	French
djembê	French
dominó	French
dossier	French
dossiê	French
drenar	French
dronte	French
dublagem	French
dublar	French
dublê	French
ducha	French
duche	French
Dufour	French
duna	French
dupleto	French
Dupont	French
déjà vu	French
démodé	French
echarpe	French
eclosão	French
ecrã	French
editar	French
edredom	French
egiptologia	French
egiptólogo	French
eglefim	French
egoísta	French
elasticidade	French
eletrocutar	French
elite	French
elusivo	French
elã	French
embalar	French
embutir	French
emoção	French
endossar	French
endêmico	French
energético	French
engajar	French
enrustir	French
ensemble	French
entourage	French
entropia	French
envelope	French
enzimático	French
episódio	French
equipa	French
equipagem	French
equipar	French
equipe	French
escafandro	French
escalada	French
esclavão	French
escorbuto	French
escroque	French
esloveno	French
espacial	French
espaçonauta	French
espeque	French
espião	French
esplanada	French
esqui	French
esquimó	French
esquissar	French
esquisso	French
esquírola	French
estampar	French
este	French
estepe	French
estetoscópio	French
estore	French
estragão	French
estrumpfe	French
esturjão	French
etapa	French
etilismo	French
etilo	French
etiqueta	French
eufemismo	French
evoluir	French
excecional	French
excepcional	French
excretar	French
existencialismo	French
expertise	French
explosivo	French
expressionista	French
extensivo	French
extensível	French
fabliau	French
faceta	French
faiança	French
falha	French
falésia	French
fantasmagoria	French
fantoche	French
fatalidade	French
federativo	French
felonia	French
feminista	French
femme fatale	French
festival	French
fetiche	French
ficha	French
fila	French
filete	French
filé	French
flamboaiã	French
flamboyant	French
Flandres	French
flanela	French
florete	French
fluorescente	French
fluorescência	French
foie gras	French
fondue	French
fonética	French
fonético	French
forja	French
forragem	French
fosfato	French
fotografia	French
framboesa	French
francófono	French
franja	French
franjar	French
frapé	French
frapê	French
fresa	French
fressura	French
frete	French
frigidaire	French
frisar	French
fronte	French
frota	French
fuinha	French
funcional	French
funcionar	French
funcionário	French
furgoneta	French
furgão	French
fuselagem	French
fuê	French
gabinete	French
gafe	French
galante	French
galimatias	French
galocha	French
galope	French
galvânico	French
galão	French
ganga	French
garagem	French
garante	French
garantir	French
garança	French
gare	French
garupa	French
garçom	French
garçon	French
garçonnière	French
gasolina	French
gastronomia	French
gastrónomo	French
gelatina	French
geleia	French
generativo	French
geologia	French
gigolô	French
gigote	French
gigó	French
gigô	French
girassol	French
girofle	French
Gisela	French
glace	French
glacé	French
glacê	French
glifo	French
gnosticismo	French
gnu	French
Godard	French
gorgorão	French
gorja	French
gouine	French
Goulart	French
gourmand	French
gourmet	French
graal	French
grafite	French
grafo	French
granada	French
Grand Prix	French
gratinar	French
gravar	French
gravata	French
gravura	French
grená	French
greve	French
grevista	French
grife	French
grimório	French
gripe	French
grisalho	French
grisar	French
griso	French
grisu	French
grisão	French
Grisões	French
groselha	French
grua	French
guache	French
guacho	French
guardanapo	French
guidão	French
guilhotina	French
guindar	French
guindaste	French
guipura	French
guisa	French
gás	French
hachura	French
Haiti	French
hangar	French
haras	French
Hebert	French
hectare	French
helicóptero	French
Heloísa	French
hemácia	French
herbívoro	French
heroína	French
heráldica	French
heráldico	French
hidráulica	French
hidráulico	French
higiene	French
hotel	French
hulha	French
humanitário	French
Hungria	French
hussardo	French
ilusionista	French
impasse	French
impressionismo	French
instalar	French
instalação	French
intendente	French
intercultural	French
internacional	French
irreprochável	French
isolar	French
Ivete	French
Ivone	French
içar	French
jade	French
janota	French
jante	French
jaqueta	French
jarda	French
jardinagem	French
jardinar	French
jargão	French
jarreteira	French
Jean	French
joalharia	French
joalheiro	French
joalheria	French
jornal	French
jornalismo	French
jornalista	French
joule	French
jujuba	French
jusante	French
laboratório	French
lactose	French
lanceta	French
Landry	French
lansquenete	French
Laos	French
Lapointe	French
laquê	French
Laurier	French
Leblanc	French
legislativo	French
Legrand	French
Leroux	French
leste	French
letão	French
licorne	French
ligeiro	French
lignite	French
limousine	French
limusina	French
limusine	French
limítrofe	French
linfático	French
lingerie	French
lingote	French
linguística	French
linhite	French
liça	French
Liège	French
looping	French
losango	French
lotaria	French
loteria	French
luneta	French
lupa	French
macabro	French
macla	French
madame	French
magnésia	French
Maine	French
maionese	French
maiô	French
major	French
mala	French
malha	French
mamute	French
mamã	French
manche	French
manchete	French
manequim	French
manete	French
manicure	French
manilha	French
manipular	French
manivela	French
manjar	French
manobra	French
manobrar	French
maquete	French
maquilhar	French
maquis	French
marabu	French
marcha	French
marchand	French
marchar	French
marechal	French
margarina	French
marionete	French
marmita	French
marmota	French
marquesa	French
marquise	French
Marraquexe	French
marrom	French
maré	French
mascote	French
massacre	French
massagem	French
massivo	French
matiné	French
matinê	French
maçonaria	French
mação	French
mecha	French
mediatizar	French
menestrel	French
menir	French
menu	French
merengue	French
mesão	French
metano	French
metila	French
metilo	French
metralha	French
metro	French
Metz	French
Michel	French
mignon	French
milieu	French
milionário	French
minete	French
minoritário	French
mirabolante	French
miragem	French
mise-en-scène	French
mistificar	French
mitene	French
mocassim	French
moina	French
moletom	French
molécula	French
monetizar	French
Montpellier	French
montra	French
Montreal	French
moreia	French
morena	French
morgue	French
morrião	French
mosaico	French
mosquete	French
mote	French
motilidade	French
motim	French
motocicleta	French
motor	French
muche	French
muezim	French
musse	French
médium	French
ménage	French
ménage à trois	French
múpi	French
nacional	French
narguilé	French
naveta	French
neerlandês	French
negritude	French
neoprene	French
Nice	French
nicho	French
nicotina	French
noblesse oblige	French
nordeste	French
Normandia	French
norte	French
nuance	French
numismática	French
nécessaire	French
nórdico	French
obreia	French
observatório	French
obus	French
odalisca	French
oeste	French
ofensiva	French
ogro	French
omelete	French
ontologia	French
opalescente	French
organizar	French
orgia	French
oxigénio	French
pacifista	French
pacotilha	French
paetê	French
paisagem	French
paladino	French
palete	French
paletó	French
panachê	French
pane	French
panfleto	French
panteísta	French
papelote	French
papá	French
parapente	French
parcela	French
parkour	French
parlamento	French
parque	French
parvenu	French
paródia	French
Pas-de-Calais	French
passagem	French
passaporte	French
patafísica	French
patchuli	French
patinete	French
patoá	French
patrulha	French
patrulhar	French
patê	French
pavilhão	French
pavê	French
país	French
pejorativo	French
pelotão	French
peluche	French
Perpignan	French
peruca	French
petanca	French
petiz	French
pica	French
Picardia	French
picota	French
picotagem	French
picotar	French
Pierre	French
pietista	French
pilão	French
pinguim	French
pinta	French
pinça	French
pipeta	French
piquenique	French
Piquet	French
piquete	French
piroga	French
pisseta	French
pitão	French
pivô	French
piça	French
placar	French
placard	French
plafom	French
plafond	French
plantão	French
plaqueta	French
plataforma	French
platitude	French
platô	French
pleonástico	French
pneumático	French
pochete	French
polaina	French
polia	French
polichinelo	French
pomada	French
pompom	French
pontuar	French
Port Louis	French
porta-fólio	French
posar	French
pose	French
positivismo	French
positivista	French
postar	French
prancha	French
predileção	French
premiê	French
prestidigitador	French
princesa	French
prisão	French
propano	French
protestante	French
proveta	French
proxeneta	French
psicanálise	French
pterodáctilo	French
pufe	French
pulsátil	French
punitivo	French
puré	French
purê	French
pónei	French
quartel	French
quatrilhão	French
Quebec	French
Quebeque	French
quermesse	French
querosene	French
quiche	French
quilha	French
quinquilharia	French
quintilhão	French
quiosque	French
ragu	French
raison d'être	French
rampa	French
randevu	French
ranhura	French
rapel	French
rapieira	French
rappel	French
rapé	French
raquete	French
ratafia	French
Raul	French
ravina	French
razia	French
reator	French
reação	French
rebordo	French
recital	French
reclame	French
regalar	French
reineta	French
relé	French
rena	French
Renaud	French
Renault	French
rendez-vous	French
rentrée	French
rentável	French
Renânia	French
reportagem	French
reprise	French
responsável	French
restaurante	French
revanche	French
revoltar	French
rima	French
ripostar	French
risco	French
rissol	French
robe	French
robotizar	French
robô	French
rocha	French
rococó	French
rolar	French
roleta	French
romanche	French
romântico	French
rosé	French
rotativo	French
rotim	French
rotina	French
rotisseria	French
Rouen	French
roulotte	French
rulote	French
runa	French
réveillon	French
rímel	French
sabonete	French
sabre	French
sacudu	French
salada	French
samovar	French
sanitário	French
sargento	French
savoir-faire	French
saxofone	French
seiva	French
semiótica	French
semiótico	French
semáforo	French
sentimental	French
serval	French
silfo	French
silhueta	French
simbólico	French
Simone	French
sirene	French
siroco	French
Sião	French
smoking	French
socialismo	French
socialista	French
sociologia	French
soclo	French
sofisticar	French
sofá	French
solucionar	French
sommelier	French
sonda	French
sondagem	French
soquete	French
sorbet	French
sorvete	French
soufflé	French
soutien	French
sucursal	French
sudeste	French
sudoeste	French
sudorífico	French
suflé	French
suflê	French
sugestivo	French
supremacia	French
suricate	French
surpreender	French
surpresa	French
surrealismo	French
surrealista	French
sursis	French
surtir	French
suserano	French
sutiã	French
suvenir	French
suíte	French
sílfide	French
tabagismo	French
tablete	French
tachar	French
talismã	French
talão	French
tampão	French
tangão	French
tarja	French
tarte	French
tartelete	French
telefone	French
tensor	French
teodiceia	French
Terra de Adélie	French
terraço	French
testosterona	French
teísta	French
timbale	French
Tintim	French
tiquê	French
toalete	French
toesa	French
toilette	French
Tonquim	French
torniquete	French
totalitário	French
touché	French
transe	French
trapaça	French
travesti	French
travestir	French
trema	French
treno	French
trenó	French
tri	French
tri-	French
triagem	French
triar	French
tribal	French
trilhão	French
trincheira	French
tro	French
trombeta	French
trompeta	French
trompete	French
tropa	French
trotineta	French
trotinete	French
truque	French
tufo	French
tundra	French
tupinambo	French
tupinambor	French
turbina	French
turné	French
turnê	French
tática	French
táxi	French
técnico	French
tête-à-tête	French
ureia	French
usina	French
usinar	French
utilizar	French
vacinostilo	French
vagão	French
valet	French
valete	French
valise	French
valsa	French
vampiro	French
vanguarda	French
vantagem	French
varicela	French
velour	French
velódromo	French
vendaval	French
vendável	French
verlan	French
viela	French
vinagrete	French
vinheta	French
visar	French
vitral	French
vitrificar	French
vitrine	French
viável	French
viés	French
víveres	French
Watremez	French
xisto	French
zebu	French
zero	French
ziguezague	French
zircão	French
zé fini	French
écharpe	French
écran	French
élan	French
ímã	French
óxido	French
Abitur	German
alergia	German
Altenhofen	German
alto	German
andebol	German
anilina	German
apofenia	German
Appenzell	German
Augsburgo	German
benzeno	German
Blauschild	German
blenda	German
blindar	German
blitzkrieg	German
Blumenfeld	German
Blumenkopf	German
Blumenthal	German
Braunschild	German
Bremen	German
Burgenland	German
Bündchen	German
came	German
carste	German
cetona	German
cobalto	German
Constança	German
cuca	German
cuque	German
cáiser	German
Eckstein	German
Edelschild	German
Edelstein	German
Einstein	German
Eisenstein	German
Embach	German
Epstein	German
Estetino	German
Etsch	German
fagócito	German
Feuerstein	German
Frankfurt	German
Geisel	German
Gestapo	German
Gláuber	German
gneisse	German
Goldfarb	German
Goldkopf	German
Goldstein	German
hamster	German
Haufschild	German
Hauschild	German
Hauschildt	German
Haydn	German
Hermano	German
hertz	German
Hesse	German
Hilda	German
Hitler	German
Hochschild	German
Interlaken	German
introjeção	German
kaiser	German
kitsch	German
Konigsberg	German
Kulm	German
Kurtenbach	German
Leipzig	German
Lemberga	German
LSD	German
Mainz	German
Mattheis	German
Memel	German
Meyer	German
mol	German
Mozart	German
Nassau	German
neandertal	German
Neuberger	German
níquel	German
númeno	German
Odebrecht	German
oma	German
opa	German
Oto	German
ozono	German
penal	German
Pernau	German
Pilsen	German
pinscher	German
Posen	German
pretzel	German
quark	German
Rapunzel	German
Reich	German
Rosenstein	German
Rosenthal	German
Roth	German
Rothkopf	German
Rothschild	German
Rothstein	German
rottweiler	German
Salzburgo	German
Schadenfreude	German
Schengen	German
Schild	German
Schleswig-Holstein	German
schnapps	German
schnaps	German
schnitzel	German
Schroeder	German
Schubert	German
Schumann	German
Schwartz	German
Schwarz	German
Schwarzkopf	German
Schwarzschild	German
Schweitzer	German
Schweizer	German
Stein	German
Stern	German
Strauss	German
strudel	German
talvegue	German
vampiro	German
vendo	German
volfrâmio	German
Weinstein	German
Weintraub	German
Weishaupt	German
Wiesemann	German
Wolfgang	German
Worms	German
xote	German
zeitgeist	German
zepelim	German
álbum	German
abibe	Hebrew
Adonai	Hebrew
alef	Hebrew
Arã	Hebrew
Assuero	Hebrew
cabala	Hebrew
Calebe	Hebrew
Chanucá	Hebrew
Coré	Hebrew
Eloá	Hebrew
Jair	Hebrew
Javé	Hebrew
kibutz	Hebrew
menorá	Hebrew
Miriam	Hebrew
quipá	Hebrew
Shavuot	Hebrew
Talmude	Hebrew
Tel Aviv	Hebrew
uau	Hebrew
a cappella	Italian
Abruzzo	Italian
acampar	Italian
acciaccatura	Italian
acqua alta	Italian
adagietto	Italian
Adige	Italian
adágio	Italian
aggiornamento	Italian
agitato	Italian
Agrigento	Italian
aguentar	Italian
agência	Italian
aioli	Italian
alar	Italian
albarello	Italian
alegreto	Italian
alegro	Italian
Alepo	Italian
Aleppo	Italian
alerta	Italian
Alessandra	Italian
Alessandro	Italian
Alghero	Italian
allegretto	Italian
allegro	Italian
amarone	Italian
andante	Italian
angariar	Italian
Aosta	Italian
apartamento	Italian
aquarela	Italian
arbório	Italian
Arezzo	Italian
arlequim	Italian
Arno	Italian
arpejo	Italian
arquipélago	Italian
arquivolta	Italian
arrivederci	Italian
arte povera	Italian
artista	Italian
aspirante	Italian
assassinar	Italian
atacar	Italian
Baccarin	Italian
bagatela	Italian
balcão	Italian
baldaquino	Italian
bancarrota	Italian
banco	Italian
bandido	Italian
bandolim	Italian
baqueta	Italian
Bataglia	Italian
Battaglia	Italian
batuta	Italian
bazar	Italian
beladona	Italian
beleza	Italian
belvedere	Italian
bemol	Italian
Benevento	Italian
bergamota	Italian
Bianca	Italian
Bianchi	Italian
bisbilhotar	Italian
bisca	Italian
bizarro	Italian
bocha	Italian
bojarda	Italian
boleto	Italian
Bolsonaro	Italian
bomba	Italian
bombazine	Italian
botequim	Italian
bravata	Italian
bravo	Italian
bravura	Italian
briga	Italian
brilhar	Italian
Brindisi	Italian
brusco	Italian
brusqueta	Italian
brócolis	Italian
bufo	Italian
bufão	Italian
Buonauro	Italian
burlesco	Italian
bússola	Italian
cadência	Italian
cafona	Italian
calma	Italian
camarim	Italian
camerlengo	Italian
campeão	Italian
Campânia	Italian
canalha	Italian
canhão	Italian
capitel	Italian
cappuccino	Italian
capricho	Italian
caprichoso	Italian
capuchino	Italian
capucho	Italian
carestia	Italian
caricatura	Italian
carnaval	Italian
carnavalesco	Italian
carroça	Italian
cartolina	Italian
carícia	Italian
cascata	Italian
casino	Italian
catafalco	Italian
cavalete	Italian
cavilha	Italian
cequim	Italian
chiaroscuro	Italian
chicória	Italian
chinela	Italian
cicerone	Italian
cimitarra	Italian
colina	Italian
colorir	Italian
comparsa	Italian
concerto	Italian
confeito	Italian
confete	Italian
confetti	Italian
contrabando	Italian
contralto	Italian
contrastar	Italian
corsário	Italian
cortejar	Italian
credência	Italian
crédito	Italian
culatra	Italian
cúpula	Italian
Danilo	Italian
Dante	Italian
desenhar	Italian
desenvolto	Italian
diletante	Italian
Donizete	Italian
drapejar	Italian
duo	Italian
durante	Italian
Durazzo	Italian
dó	Italian
embriaguez	Italian
empresa	Italian
empresário	Italian
esbelto	Italian
esboço	Italian
esbórnia	Italian
escala	Italian
escaramuça	Italian
escarola	Italian
escarpa	Italian
escolho	Italian
escoltar	Italian
esdrúxulo	Italian
esgrafito	Italian
espadachim	Italian
espaguete	Italian
esparguete	Italian
espineta	Italian
espingarda	Italian
espoleta	Italian
estafeta	Italian
estilete	Italian
estivar	Italian
estornar	Italian
estrilar	Italian
estufa	Italian
estufar	Italian
estância	Italian
expresso	Italian
fachada	Italian
falsete	Italian
farol	Italian
fascismo	Italian
Fata Morgana	Italian
favorito	Italian
fermata	Italian
ferrovia	Italian
fiasco	Italian
figurino	Italian
filigrana	Italian
finale	Italian
firma	Italian
Fittipaldi	Italian
florim	Italian
fracasso	Italian
fragata	Italian
Franzese	Italian
fresco	Italian
friulano	Italian
fuga	Italian
fusa	Italian
gabão	Italian
gajeiro	Italian
gala	Italian
galeria	Italian
Galileu	Italian
gamba	Italian
garbo	Italian
gazeta	Italian
gelosia	Italian
Geovane	Italian
Giannuzzi	Italian
Gioconda	Italian
Giovana	Italian
girafa	Italian
girândola	Italian
gnocchi	Italian
Gonzaga	Italian
gonzo	Italian
grafite	Italian
grafito	Italian
grafíti	Italian
grana	Italian
grandioso	Italian
granito	Italian
grota	Italian
grotesco	Italian
grupo	Italian
gualdir	Italian
gueto	Italian
Guzzo	Italian
Génova	Italian
gôndola	Italian
imbróglio	Italian
infantaria	Italian
janízaro	Italian
jogatina	Italian
laguna	Italian
lambreta	Italian
largo	Italian
lasanha	Italian
lazareto	Italian
lira	Italian
litorâneo	Italian
Livorno	Italian
livreto	Italian
lombardo	Italian
Longaretti	Italian
Lucarelli	Italian
lá	Italian
lápis	Italian
líbero	Italian
lógia	Italian
maestrina	Italian
maestro	Italian
mafioso	Italian
malagueta	Italian
malandrino	Italian
Malta	Italian
malária	Italian
mandorla	Italian
manejar	Italian
manganela	Italian
manjar	Italian
marcar	Italian
medalha	Italian
mercearia	Italian
Messina	Italian
milhão	Italian
Milão	Italian
miniatura	Italian
mira	Italian
modelo	Italian
mofo	Italian
mola	Italian
monsenhor	Italian
mosaico	Italian
muralha	Italian
Médici	Italian
napolitano	Italian
nhoque	Italian
nigromante	Italian
novela	Italian
oboé	Italian
onça	Italian
Orlando	Italian
orçar	Italian
ossobuco	Italian
palafita	Italian
palco	Italian
Palermo	Italian
paleta	Italian
palhaço	Italian
panetone	Italian
panettone	Italian
paparazzo	Italian
partitura	Italian
passeata	Italian
pastel	Italian
patrazana	Italian
pavês	Italian
paúra	Italian
pedante	Italian
penacho	Italian
Piacenza	Italian
pianissimo	Italian
piano	Italian
Piemonte	Italian
Pietro	Italian
piloto	Italian
Pinóquio	Italian
pitoresco	Italian
piza	Italian
pizza	Italian
pizzaiolo	Italian
polenta	Italian
poltrona	Italian
Porciúncula	Italian
porpeta	Italian
posta	Italian
pozolana	Italian
predela	Italian
presto	Italian
prosciutto	Italian
pântano	Italian
pécora	Italian
pérgola	Italian
Pó	Italian
ragu	Italian
Randazzo	Italian
raça	Italian
retrato	Italian
ribalta	Italian
Rinaldi	Italian
rota	Italian
Rovigo	Italian
rubato	Italian
salame	Italian
saldo	Italian
Schiavone	Italian
sentinela	Italian
serenata	Italian
Siracusa	Italian
sojornar	Italian
soldado	Italian
solo	Italian
sonata	Italian
soneto	Italian
soprano	Italian
Soprano	Italian
staccato	Italian
sêmola	Italian
talharim	Italian
Taliani	Italian
Tamborini	Italian
Tamburello	Italian
Tamburi	Italian
Tamburini	Italian
Tanzini	Italian
Tarantini	Italian
Tarantino	Italian
tartaruga	Italian
tchau	Italian
tchim-tchim	Italian
tenor	Italian
tintim	Italian
tiramisu	Italian
Tomei	Italian
torso	Italian
Toselli	Italian
Toso	Italian
totalitário	Italian
Totino	Italian
Tozzo	Italian
Trapanese	Italian
Travaglia	Italian
Travaglio	Italian
Traversa	Italian
Travia	Italian
Trebbi	Italian
Trentin	Italian
Trentini	Italian
Trento	Italian
Tresoldi	Italian
Trieste	Italian
Trincavelli	Italian
Trobbiani	Italian
Troisi	Italian
trombone	Italian
Tropea	Italian
Trotta	Italian
Trupiano	Italian
Trussardi	Italian
tráfego	Italian
tráfico	Italian
turbante	Italian
Turchetta	Italian
Turchi	Italian
Turci	Italian
Turrini	Italian
Tutino	Italian
Tuzzolino	Italian
ufa	Italian
Verdi	Italian
vespa	Italian
violino	Italian
violoncelo	Italian
virtuoso	Italian
Vivaldi	Italian
vólvulo	Italian
zabaione	Italian
Ângelo	Italian
Ísquia	Italian
ópera	Italian
aikido	Japanese
ainoco	Japanese
Akio	Japanese
Akita	Japanese
Amaterasu	Japanese
Ame-no-Uzume	Japanese
anime	Japanese
arigatô	Japanese
Assaí	Japanese
babaca	Japanese
biombo	Japanese
bonsai	Japanese
bonzo	Japanese
caqui	Japanese
carateca	Japanese
caratê	Japanese
catana	Japanese
coco	Japanese
daimio	Japanese
fugu	Japanese
Fujihara	Japanese
Fujii	Japanese
Fujimori	Japanese
Fujimura	Japanese
Fujisaki	Japanese
Fujisawa	Japanese
Fujitani	Japanese
Fujiwara	Japanese
Fukuda	Japanese
Fukui	Japanese
Fukushima	Japanese
Furubayashi	Japanese
Furube	Japanese
Furuda	Japanese
Furugawa	Japanese
Furuhara	Japanese
Furuhashi	Japanese
Furuhata	Japanese
Furui	Japanese
Furuichi	Japanese
Furuike	Japanese
Furukawa	Japanese
Furuki	Japanese
Furuko	Japanese
Furukubo	Japanese
Furumi	Japanese
Furumori	Japanese
Furumoto	Japanese
Furumura	Japanese
Furuno	Japanese
Furuoka	Japanese
Furusaka	Japanese
Furusaki	Japanese
Furusato	Japanese
Furusawa	Japanese
Furushima	Japanese
Furushiro	Japanese
Furusho	Japanese
Furuta	Japanese
Furutake	Japanese
Furutani	Japanese
Furuuchi	Japanese
Furuya	Japanese
Furuyama	Japanese
Furuzawa	Japanese
Fushimi	Japanese
Fuyuko	Japanese
gueixa	Japanese
hashi	Japanese
hibakusha	Japanese
Hiroxima	Japanese
Honda	Japanese
ippon	Japanese
jiu-jitsu	Japanese
joquempô	Japanese
judo	Japanese
judoca	Japanese
kabuki	Japanese
Kagawa	Japanese
Kagoshima	Japanese
Kakutani	Japanese
kamikaze	Japanese
Kaneda	Japanese
Kaneko	Japanese
Kaneshiro	Japanese
kanji	Japanese
Kanroji	Japanese
karaokê	Japanese
karaté	Japanese
Kashiwagi	Japanese
katakana	Japanese
Katayama	Japanese
Kato	Japanese
Kawaguchi	Japanese
kawaii	Japanese
Kawano	Japanese
Kawashima	Japanese
Kazuko	Japanese
Keiko	Japanese
Kimishima	Japanese
Kimura	Japanese
Kinoshita	Japanese
Kirishima	Japanese
Kishi	Japanese
Kobayashi	Japanese
Kobori	Japanese
Kochi	Japanese
Koharu	Japanese
Koizumi	Japanese
Kojima	Japanese
Komatsu	Japanese
Komori	Japanese
Komuro	Japanese
Kondo	Japanese
Kono	Japanese
Kosaka	Japanese
Koyama	Japanese
Kumada	Japanese
Kumagawa	Japanese
Kumakawa	Japanese
Kumakura	Japanese
Kumamoto	Japanese
Kumasawa	Japanese
Kumatani	Japanese
Kumayama	Japanese
Kumazawa	Japanese
Kumiko	Japanese
Kurobane	Japanese
Kuroda	Japanese
Kurusu	Japanese
Kuwazuru	Japanese
manga	Japanese
mangá	Japanese
matcha	Japanese
Matsuyama	Japanese
micado	Japanese
Monte Fuji	Japanese
Nagasaki	Japanese
Nagasáqui	Japanese
Naha	Japanese
nigiri	Japanese
Okazaki	Japanese
oniguiri	Japanese
origâmi	Japanese
Osaca	Japanese
Osaka	Japanese
otaku	Japanese
poncã	Japanese
Quambacudono	Japanese
quimono	Japanese
ramen	Japanese
romaji	Japanese
ronin	Japanese
Saburo	Japanese
Sachiko	Japanese
Sadako	Japanese
Saionji	Japanese
Sakagawa	Japanese
Sakahara	Japanese
Sakai	Japanese
Sakasaki	Japanese
Sakashita	Japanese
Sakazaki	Japanese
sake	Japanese
Sakimura	Japanese
sakura	Japanese
Sakura	Japanese
Sakurai	Japanese
Samejima	Japanese
samurai	Japanese
Sano	Japanese
saqué	Japanese
saquê	Japanese
Saruwatari	Japanese
Sasaki	Japanese
sashimi	Japanese
Seihei	Japanese
Seiji	Japanese
sensei	Japanese
Serizawa	Japanese
Setogawa	Japanese
Setoguchi	Japanese
Setsuko	Japanese
Shibata	Japanese
Shigeko	Japanese
Shigeo	Japanese
shiitake	Japanese
Shima	Japanese
Shimabara	Japanese
Shimabukuro	Japanese
Shimada	Japanese
Shimahara	Japanese
Shimakawa	Japanese
Shimamura	Japanese
Shimauchi	Japanese
Shimazaki	Japanese
Shimazu	Japanese
Shimizu	Japanese
Shimoji	Japanese
Shimura	Japanese
Shingaki	Japanese
Shinpei	Japanese
Shirakawa	Japanese
Shiroma	Japanese
Shizuko	Japanese
Shohei	Japanese
Shoji	Japanese
shoyu	Japanese
soba	Japanese
sobá	Japanese
Soejima	Japanese
Sonoda	Japanese
sudoku	Japanese
Sugahara	Japanese
Sugawara	Japanese
Sugiyama	Japanese
Sumitomo	Japanese
sumo	Japanese
sushi	Japanese
Suzuki	Japanese
Takai	Japanese
tanuki	Japanese
tatame	Japanese
tatâmi	Japanese
tempurá	Japanese
tofu	Japanese
tokusatsu	Japanese
tonfa	Japanese
Toyota	Japanese
tsunami	Japanese
tsunâmi	Japanese
umami	Japanese
Utsunomiya	Japanese
wasabi	Japanese
xogum	Japanese
Yaeko	Japanese
Yaguchi	Japanese
Yamada	Japanese
Yamagata	Japanese
Yamagawa	Japanese
Yamakuchi	Japanese
Yamamoto	Japanese
Yamamura	Japanese
Yamanaka	Japanese
Yamane	Japanese
Yamasaki	Japanese
Yamashiro	Japanese
Yamashita	Japanese
Yamauchi	Japanese
Yamazaki	Japanese
Yasuko	Japanese
Yasutoshi	Japanese
Yazawa	Japanese
Yokoyama	Japanese
Yomiko	Japanese
Yonai	Japanese
Yoshida	Japanese
Yoshihisa	Japanese
Yoshiko	Japanese
Yoshitaro	Japanese
Yoshizaki	Japanese
Yui	Japanese
Yuiko	Japanese
Yukawa	Japanese
Yukie	Japanese
Yukio	Japanese
Yuko	Japanese
baia	Kimbundu
bamba	Kimbundu
bassula	Kimbundu
bazar	Kimbundu
berimbau	Kimbundu
bunda	Kimbundu
bundar	Kimbundu
bué	Kimbundu
cabungo	Kimbundu
cachimbo	Kimbundu
cacimba	Kimbundu
cafife	Kimbundu
cafofo	Kimbundu
cafuné	Kimbundu
calombo	Kimbundu
camundongo	Kimbundu
Candomblé	Kimbundu
candomblé	Kimbundu
candonga	Kimbundu
capanga	Kimbundu
carimbo	Kimbundu
catinga	Kimbundu
catolotolo	Kimbundu
caçamba	Kimbundu
caçula	Kimbundu
cochilar	Kimbundu
cota	Kimbundu
cubata	Kimbundu
curinga	Kimbundu
dendê	Kimbundu
fubá	Kimbundu
ganga	Kimbundu
ganja	Kimbundu
ginguba	Kimbundu
jiló	Kimbundu
kilombo	Kimbundu
kimbanda	Kimbundu
kizomba	Kimbundu
mabeco	Kimbundu
maboque	Kimbundu
maconha	Kimbundu
macumba	Kimbundu
mambo	Kimbundu
marimbondo	Kimbundu
marufo	Kimbundu
matumbo	Kimbundu
maxixe	Kimbundu
moleque	Kimbundu
moqueca	Kimbundu
muamba	Kimbundu
mucama	Kimbundu
musseque	Kimbundu
muvuca	Kimbundu
muxiba	Kimbundu
muxibas	Kimbundu
muxoxo	Kimbundu
ndengue	Kimbundu
ndungue	Kimbundu
ngá	Kimbundu
Pomba Gira	Kimbundu
quenga	Kimbundu
quilombo	Kimbundu
quimbanda	Kimbundu
Quimbanda	Kimbundu
quimbundo	Kimbundu
quingombó	Kimbundu
quitanda	Kimbundu
quito	Kimbundu
quitute	Kimbundu
quixima	Kimbundu
quixiquila	Kimbundu
quizila	Kimbundu
quizomba	Kimbundu
quizumba	Kimbundu
semba	Kimbundu
senzala	Kimbundu
soba	Kimbundu
sunga	Kimbundu
timbo	Kimbundu
xingar	Kimbundu
zumbi	Kimbundu
Anapa	Russian
Andreev	Russian
Andrei	Russian
Antonoff	Russian
Antonov	Russian
artel	Russian
Baba Yaga	Russian
Baical	Russian
balalaica	Russian
Bielorrússia	Russian
Bogdanov	Russian
bolchevique	Russian
Borisoff	Russian
Borisov	Russian
Carcóvia	Russian
Cazaquistão	Russian
Chernobil	Russian
chernozem	Russian
Chukotka	Russian
Comintern	Russian
cosmonauta	Russian
Cuban	Russian
czar	Russian
Cátia	Russian
Dimitri	Russian
Dmitri	Russian
Dniepre	Russian
Dubinsky	Russian
Dudinka	Russian
Estaline	Russian
Feodosia	Russian
glasnost	Russian
Ialta	Russian
Ienissei	Russian
Igor	Russian
Inguchétia	Russian
Irtish	Russian
Ivan	Russian
Ivanoff	Russian
Ivanov	Russian
Kalinin	Russian
Kamchatka	Russian
kazatchok	Russian
Kiev	Russian
Kirov	Russian
Komsomolsk	Russian
Kouznetsoff	Russian
Kouznetsov	Russian
Kuznecov	Russian
Kuznetsoff	Russian
Kuznetsov	Russian
Lebedeff	Russian
Lebedev	Russian
Lenine	Russian
Levandovsky	Russian
Levitsky	Russian
Ládoga	Russian
Maikop	Russian
Malkoff	Russian
Malkov	Russian
matrioshka	Russian
Medvedeff	Russian
Medvedev	Russian
Mir	Russian
Mogilev	Russian
Mordóvia	Russian
Morozoff	Russian
Morozov	Russian
Natasha	Russian
Naumoff	Russian
nenets	Russian
Nijni Novgorod	Russian
Nina	Russian
nomenclatura	Russian
Norilsk	Russian
Nádia	Russian
Ob	Russian
Olga	Russian
Orel	Russian
Petroff	Russian
Petrov	Russian
Popoff	Russian
Popov	Russian
Primorsky	Russian
Prokofiev	Russian
Quieve	Russian
Rostov	Russian
samoiedo	Russian
Serguei	Russian
Smirnoff	Russian
Smirnov	Russian
Sokoloff	Russian
Sokolov	Russian
Sokolsky	Russian
Stalingrado	Russian
Stepanoff	Russian
Stepanov	Russian
Sónia	Russian
Sônia	Russian
Tatiana	Russian
Togliatti	Russian
Trótski	Russian
Tânia	Russian
Ulan Bator	Russian
Vasiliev	Russian
Vassili	Russian
vetche	Russian
Vladimiroff	Russian
Vladimirov	Russian
vodka	Russian
Volga	Russian
Voronej	Russian
Vorontsoff	Russian
Vorontsov	Russian
Vânia	Russian
Yamal	Russian
Yuri	Russian
abajeru	Old Tupi
abati	Old Tupi
Abatiá	Old Tupi
abiu	Old Tupi
acaju	Old Tupi
aguapé	Old Tupi
aguaraçu	Old Tupi
Aguaí	Old Tupi
Aimberê	Old Tupi
Aimbirê	Old Tupi
aipim	Old Tupi
Amapá	Old Tupi
ambaíba	Old Tupi
amendoim	Old Tupi
ananás	Old Tupi
anauê	Old Tupi
Andirá	Old Tupi
anhanguera	Old Tupi
anu	Old Tupi
aracuã	Old Tupi
arapapá	Old Tupi
araponga	Old Tupi
arapuca	Old Tupi
arara	Old Tupi
araracanga	Old Tupi
arará	Old Tupi
araçari	Old Tupi
ariramba	Old Tupi
ariranha	Old Tupi
aruanã	Old Tupi
ará	Old Tupi
aturá	Old Tupi
Avaré	Old Tupi
babaca	Old Tupi
bacuri	Old Tupi
baiacu	Old Tupi
beiju	Old Tupi
beruanha	Old Tupi
boipeva	Old Tupi
buriti	Old Tupi
butiá	Old Tupi
caba	Old Tupi
caburé	Old Tupi
caeté	Old Tupi
caju	Old Tupi
cambacica	Old Tupi
cangambá	Old Tupi
canindé	Old Tupi
capim	Old Tupi
capivara	Old Tupi
capixaba	Old Tupi
capão	Old Tupi
caramuru	Old Tupi
carapanã	Old Tupi
carcará	Old Tupi
carimbó	Old Tupi
carimã	Old Tupi
carnaúba	Old Tupi
Catanduvas	Old Tupi
catapora	Old Tupi
catinga	Old Tupi
catupiry	Old Tupi
cauim	Old Tupi
Cauã	Old Tupi
Cauê	Old Tupi
caá	Old Tupi
cipó	Old Tupi
copiar	Old Tupi
copiara	Old Tupi
cuandu	Old Tupi
cuia	Old Tupi
cunhantã	Old Tupi
cunhã	Old Tupi
cunhã-poranga	Old Tupi
cupim	Old Tupi
curimã	Old Tupi
Curitiba	Old Tupi
cururu	Old Tupi
cutia	Old Tupi
cuíca	Old Tupi
embuá	Old Tupi
gororoba	Old Tupi
guaiamum	Old Tupi
guaju-guaju	Old Tupi
guapuruvu	Old Tupi
guarajuba	Old Tupi
guariba	Old Tupi
Guarujá	Old Tupi
guaruçá	Old Tupi
guará	Old Tupi
guaxima	Old Tupi
guaxinim	Old Tupi
guirajuba	Old Tupi
guri	Old Tupi
Ibirapitanga	Old Tupi
Ibirá	Old Tupi
Igarassu	Old Tupi
inhaca	Old Tupi
Ipanema	Old Tupi
ipê	Old Tupi
ir para a cucuia	Old Tupi
irara	Old Tupi
irá	Old Tupi
Itabira	Old Tupi
Itajaí	Old Tupi
jaborandi	Old Tupi
jaburu	Old Tupi
jabuti	Old Tupi
jabuticaba	Old Tupi
jacarandá	Old Tupi
jacaré	Old Tupi
jacu	Old Tupi
jacuaçu	Old Tupi
jacundá	Old Tupi
jacupemba	Old Tupi
jacá	Old Tupi
jaguar	Old Tupi
jaguara	Old Tupi
jaguaretê	Old Tupi
Janaína	Old Tupi
jararaca	Old Tupi
jaçanã	Old Tupi
jeca	Old Tupi
jererê	Old Tupi
jerimum	Old Tupi
jiboia	Old Tupi
jupará	Old Tupi
jurará-açu	Old Tupi
jurema	Old Tupi
jurubeba	Old Tupi
jururu	Old Tupi
Kauê	Old Tupi
macaxeira	Old Tupi
mamangaba	Old Tupi
mandioca	Old Tupi
mangangá	Old Tupi
maniçoba	Old Tupi
marabunta	Old Tupi
maraca	Old Tupi
Maranhão	Old Tupi
maritacaca	Old Tupi
matupá	Old Tupi
Maíra	Old Tupi
mingau	Old Tupi
Moacir	Old Tupi
mocotó	Old Tupi
moquém	Old Tupi
morupeteca	Old Tupi
mundéu	Old Tupi
muriqui	Old Tupi
muriçoca	Old Tupi
mururé	Old Tupi
mutirão	Old Tupi
muçum	Old Tupi
muçurana	Old Tupi
nhaca	Old Tupi
nhambi	Old Tupi
Niterói	Old Tupi
oca	Old Tupi
oiti	Old Tupi
paca	Old Tupi
pacova	Old Tupi
pacu	Old Tupi
pajé	Old Tupi
pamonha	Old Tupi
Paraíba	Old Tupi
Pará	Old Tupi
paçoca	Old Tupi
peconha	Old Tupi
pequi	Old Tupi
pereba	Old Tupi
perereca	Old Tupi
peroba	Old Tupi
Piatã	Old Tupi
Piauí	Old Tupi
piaçaba	Old Tupi
Pindamonhangaba	Old Tupi
pindaíba	Old Tupi
pindoba	Old Tupi
Pindoba	Old Tupi
Pindorama	Old Tupi
Pindoretama	Old Tupi
pipoca	Old Tupi
Piracicaba	Old Tupi
piranha	Old Tupi
pirão	Old Tupi
pitanga	Old Tupi
piá	Old Tupi
pocema	Old Tupi
poraquê	Old Tupi
pororoca	Old Tupi
poti	Old Tupi
potiguar	Old Tupi
preá	Old Tupi
puã	Old Tupi
puçá	Old Tupi
quati	Old Tupi
quatimundéu	Old Tupi
quipá	Old Tupi
sabiá	Old Tupi
Saci	Old Tupi
saci-pererê	Old Tupi
sagui	Old Tupi
samambaia	Old Tupi
sapecar	Old Tupi
sapucaia	Old Tupi
sapé	Old Tupi
saracura	Old Tupi
saruê	Old Tupi
sauiá	Old Tupi
saíra	Old Tupi
saúva	Old Tupi
Sergipe	Old Tupi
siri	Old Tupi
siricutico	Old Tupi
socar	Old Tupi
Sorocaba	Old Tupi
sucuri	Old Tupi
suruba	Old Tupi
surucucu	Old Tupi
suçuarana	Old Tupi
tabajara	Old Tupi
taioca	Old Tupi
tanajura	Old Tupi
tanoca	Old Tupi
taoca	Old Tupi
tapioca	Old Tupi
tapir	Old Tupi
tapiti	Old Tupi
tapuia	Old Tupi
taquara	Old Tupi
tatu	Old Tupi
tatuaçu	Old Tupi
tatuetê	Old Tupi
taturana	Old Tupi
tauoca	Old Tupi
teiú	Old Tupi
tiriba	Old Tupi
tiririca	Old Tupi
tocaia	Old Tupi
Tocantins	Old Tupi
traíra	Old Tupi
tucano	Old Tupi
tucupi	Old Tupi
tuiuiú	Old Tupi
tupi	Old Tupi
tupiniquim	Old Tupi
Tupã	Old Tupi
Ubatuba	Old Tupi
ubá	Old Tupi
uirapuru	Old Tupi
urubu	Old Tupi
urubutinga	Old Tupi
urucum	Old Tupi
urutau	Old Tupi
uçá	Old Tupi
veja	Old Tupi
voçoroca	Old Tupi
xará	Old Tupi