автаркія	Ancient Greek
автократ	Ancient Greek
Агафія	Ancient Greek
алегорія	Ancient Greek
Алупка	Ancient Greek
амнезія	Ancient Greek
аналогія	Ancient Greek
анафема	Ancient Greek
ангел	Ancient Greek
аномалія	Ancient Greek
антидот	Ancient Greek
антипатія	Ancient Greek
антологія	Ancient Greek
апокаліпсис	Ancient Greek
Артем	Ancient Greek
архангел	Ancient Greek
архонт	Ancient Greek
асиметрія	Ancient Greek
аскет	Ancient Greek
астрологія	Ancient Greek
аттик	Ancient Greek
Афродіта	Ancient Greek
варвар	Ancient Greek
Віталій	Ancient Greek
гегемонія	Ancient Greek
Геннадій	Ancient Greek
Георгій	Ancient Greek
героїня	Ancient Greek
Гордій	Ancient Greek
Данило	Ancient Greek
демагогія	Ancient Greek
демократія	Ancient Greek
дерматит	Ancient Greek
дзета	Ancient Greek
диск	Ancient Greek
дифірамб	Ancient Greek
дяк	Ancient Greek
діагностика	Ancient Greek
діаграма	Ancient Greek
діадема	Ancient Greek
діалект	Ancient Greek
діаспора	Ancient Greek
еврика	Ancient Greek
евтаназія	Ancient Greek
енергія	Ancient Greek
Есхіл	Ancient Greek
етер	Ancient Greek
етимологія	Ancient Greek
ефір	Ancient Greek
Зевс	Ancient Greek
кактус	Ancient Greek
кераміка	Ancient Greek
Кирило	Ancient Greek
кома	Ancient Greek
комора	Ancient Greek
космос	Ancient Greek
Ксеркс	Ancient Greek
кіста	Ancient Greek
Леонід	Ancient Greek
литавра	Ancient Greek
логос	Ancient Greek
Лідія	Ancient Greek
магія	Ancient Greek
Майя	Ancient Greek
марафон	Ancient Greek
Маркіян	Ancient Greek
монархія	Ancient Greek
некрополь	Ancient Greek
Ніка	Ancient Greek
оксамит	Ancient Greek
оксиморон	Ancient Greek
оладка	Ancient Greek
оладок	Ancient Greek
Олекса	Ancient Greek
Олексій	Ancient Greek
оргазм	Ancient Greek
орган	Ancient Greek
Орест	Ancient Greek
панахида	Ancient Greek
пандемія	Ancient Greek
пародія	Ancient Greek
Пасха	Ancient Greek
педагогіка	Ancient Greek
Персефона	Ancient Greek
Платон	Ancient Greek
проскура	Ancient Greek
Піфагор	Ancient Greek
сахар	Ancient Greek
Семен	Ancient Greek
симетрія	Ancient Greek
скіф	Ancient Greek
спудей	Ancient Greek
стадіон	Ancient Greek
Степан	Ancient Greek
терапевт	Ancient Greek
тета	Ancient Greek
топаз	Ancient Greek
триптих	Ancient Greek
тромбоз	Ancient Greek
тіара	Ancient Greek
фараон	Ancient Greek
Фоб	Ancient Greek
філософія	Ancient Greek
фімоз	Ancient Greek
халепа	Ancient Greek
хаос	Ancient Greek
харизма	Ancient Greek
хор	Ancient Greek
юдаїзм	Ancient Greek
янгол	Ancient Greek
Євангеліє	Ancient Greek
євнух	Ancient Greek
єврей	Ancient Greek
єретик	Ancient Greek
ігумен	Ancient Greek
башта	Czech
виз	Czech
влада	Czech
волати	Czech
карлик	Czech
костел	Czech
краля	Czech
присудок	Czech
робот	Czech
табір	Czech
тотожний	Czech
часопис	Czech
Аба	English
агностик	English
агностицизм	English
агностичний	English
адаптер	English
айфон	English
алігатор	English
антициклон	English
антропонім	English
астронавт	English
аутсайдер	English
бакс	English
бампер	English
бананова республіка	English
банджо	English
барбекю	English
бармен	English
бас-гітара	English
баскетбол	English
бекхенд	English
бестселер	English
блекаут	English
блог	English
блогер	English
блогосфера	English
блок	English
блюз	English
Боб	English
болт	English
бонд	English
бос	English
бот	English
Брайтон	English
браунінг	English
бренд	English
брендинг	English
бриз	English
брифінг	English
бро	English
бройлер	English
брокер	English
бульдог	English
бум	English
бункер	English
Буркіна-Фасо	English
бус	English
бізнес	English
бізнес-план	English
білборд	English
біфобія	English
біфштекс	English
вайфай	English
ват	English
Вашингтон	English
Вашинґтон	English
веранда	English
вестерн	English
вестернізація	English
волейбол	English
віг	English
відео	English
віскі	English
Г'юстон	English
гаджет	English
гайда	English
гайп	English
Гарфілд	English
гей	English
геймплей	English
гелікоптер	English
гендер	English
генетика	English
геноцид	English
героїн	English
Геррінґтон	English
глобалізація	English
гну	English
гобіт	English
гол	English
голограма	English
Гордон	English
Гоґвортс	English
граф	English
грумінг	English
гуава	English
Гувер	English
гугл	English
Гілі	English
гіпермаркет	English
дедлайн	English
джем	English
джентльмен	English
джойнт	English
джойстик	English
Джонсон	English
диджей	English
дизайн	English
дизайнер	English
дилер	English
дисплей	English
долар	English
Дональд Дак	English
донат	English
донатити	English
донор	English
дримкор	English
дрон	English
Едвард	English
Едуард	English
Едіта	English
екоцид	English
експорт	English
екстрасенс	English
Елвін	English
ельф	English
емпатія	English
ескалація	English
зомбі	English
калькулятор	English
камбек	English
катер	English
квест	English
Кейнс	English
кейтеринг	English
Кембридж	English
кенгуру	English
кетчуп	English
кеш	English
кластер	English
клоун	English
кліп	English
кобальт	English
коктейль	English
кола	English
комбайн	English
комп'ютер	English
комфорт	English
комікс	English
конвеєр	English
кондиціонер	English
конектор	English
консалтинг	English
контент	English
коп	English
копірайтер	English
коронавірус	English
косплей	English
крек	English
крекер	English
криндж	English
кросовер	English
кікбоксинг	English
Кіссінгер	English
Кіссінджер	English
Кіссінґер	English
лазер	English
лайк	English
лайм	English
лайфхак	English
ласо	English
ленд-ліз	English
лузер	English
лівер	English
Ліверпуль	English
лідар	English
лідер	English
майнкрафтер	English
манго	English
мангри	English
Манчестер	English
маркетинг	English
матч	English
медіум	English
мейнстрим	English
мелатонін	English
мем	English
менеджер	English
менеджмент	English
мефедрон	English
модем	English
модератор	English
моніторинг	English
Мордор	English
мультимедіа	English
Мюллер	English
містер	English
мітинг	English
НАТО	English
нонсенс	English
норміс	English
ноу-хау	English
нуклеотид	English
Нью-Йорк	English
окей	English
омбудсмен	English
Оппенгеймер	English
оптимізація	English
орк	English
Остін	English
офіс	English
пазл	English
памперс	English
Паркінсон	English
патч	English
пачулі	English
подкаст	English
поні	English
порт	English
портвейн	English
пост	English
постмодернізм	English
прайм-тайм	English
прем'єр	English
принтер	English
проактивний	English
провайдер	English
пруф	English
пудинг	English
піар	English
піджак	English
піжама	English
піксель	English
пірсинг	English
рандом	English
Раша	English
реанімація	English
регбі	English
рейв	English
рекрутер	English
респект	English
ретард	English
рок	English
рок-н-рол	English
ром	English
саміт	English
сандвіч	English
саундтрек	English
секс	English
селфхарм	English
селфі	English
сендвіч	English
сер	English
сервер	English
сервіс	English
серотонін	English
серіал	English
сканер	English
скрін	English
скін	English
скіф	English
сленг	English
смартфон	English
снайпер	English
софізм	English
спам	English
спойлер	English
спорт	English
спортсмен	English
спікер	English
спічрайтер	English
стандарт	English
стандартизація	English
старт	English
статика	English
стейк	English
степ	English
страпон	English
стрес	English
стриптиз	English
супермаркет	English
суші	English
таймер	English
танк	English
танкер	English
тату	English
тверк	English
тег	English
теніс	English
тест	English
тост	English
тостер	English
трансгендер	English
трейдер	English
трейдинг	English
тренер	English
тренінг	English
трест	English
тролейбус	English
тролити	English
троль	English
тротил	English
тунель	English
турист	English
Уельс	English
файл	English
фак	English
фан	English
фанфік	English
фейк	English
фембой	English
фермер	English
флорбол	English
флуд	English
флірт	English
фольклор	English
фонк	English
фотон	English
фур	English
фурс'ют	English
фільм	English
Хелловін	English
хентай	English
хепі-енд	English
херитажник	English
хештег	English
хобі	English
хот-дог	English
худі	English
хуліган	English
Цива	English
циклон	English
чат-бот	English
чекати	English
чекнути	English
чип	English
чипсет	English
чіпсет	English
Шекспір	English
шквал	English
шок	English
шопінг	English
шот	English
шоу	English
Шредер	English
Юкрейн	English
янкі	English
ярд	English
єй	English
ізотоп	English
імпорт	English
імпічмент	English
імхо	English
імідж	English
інгліш	English
індосамент	English
інсайдер	English
інструментал	English
інтерв'ю	English
інтерв'юер	English
інтернаціональний	English
інфляція	English
інфінітив	English
ґальон	English
Ґарфілд	English
ґей	English
ґеймплей	English
ґуґл	English
абажур	French
абреже	French
абсент	French
авангардизм	French
авангардист	French
аванложа	French
авеню	French
автоматизація	French
автопортрет	French
авторитаризм	French
авіація	French
агонія	French
агресія	French
агроном	French
агрономія	French
адепт	French
аеродром	French
аероплан	French
аеропорт	French
ажур	French
ажурний	French
азот	French
акордеон	French
акредитувати	French
акробат	French
актив	French
акушер	French
акцент	French
акцентувати	French
акціонер	French
алея	French
альбом	French
альков	French
альпінізм	French
альтернатива	French
альянс	French
аліменти	French
амплітуда	French
ангажувати	French
ангар	French
анемія	French
анкета	French
анонс	French
ансамбль	French
антагоніст	French
антонім	French
антрепренер	French
аплодисменти	French
арабеска	French
арбітр	French
арбітраж	French
арондісман	French
артист	French
архаїчний	French
асамблея	French
асорті	French
асоціація	French
астенія	French
асфальт	French
атакувати	French
ательє	French
афоризм	French
афіша	French
бабуїн	French
багаж	French
баланс	French
балон	French
балія	French
банальний	French
бандаж	French
бандероль	French
банкет	French
бар'єр	French
барак	French
барельєф	French
баржа	French
барикада	French
баркас	French
батальйон	French
батон	French
беж	French
бекас	French
бензин	French
берет	French
блок	French
блокнот	French
блондин	French
бліндаж	French
боа	French
бокал	French
бомонд	French
бона	French
бор	French
бордо	French
бот	French
бра	French
бравада	French
браслет	French
Бретань	French
брикет	French
брутальний	French
брюнет	French
букет	French
букініст	French
бульвар	French
бульйон	French
бумазея	French
буржуазний	French
буржуазія	French
бурнус	French
бутель	French
буфет	French
бюлетень	French
бюро	French
бюрократ	French
бюст	French
білет	French
білінгвізм	French
біографія	French
біолог	French
біологія	French
бістро	French
ва-банк	French
ваза	French
вальс	French
вампір	French
ваніль	French
вентиляція	French
версія	French
волонтер	French
вігонь	French
візіонер	French
вінегрет	French
газета	French
газон	French
гамак	French
гараж	French
гарнізон	French
гарнір	French
гектар	French
гемоглобін	French
гепард	French
глюкоза	French
грам	French
граніт	French
грип	French
гуаш	French
гід	French
дантист	French
дебют	French
дебіл	French
декаданс	French
декадент	French
декадентизм	French
декорум	French
делікатес	French
демократ	French
департамент	French
десерт	French
деталь	French
дециметр	French
дипломат	French
дирижабль	French
дискредитація	French
дисонанс	French
доломіт	French
доміно	French
досьє	French
дофін	French
Дофіне	French
драматург	French
драматургія	French
дубляж	French
душ	French
діагональ	French
діапазон	French
егалітаризм	French
Едуард	French
екзил	French
екзистенціалізм	French
екран	French
експансія	French
експертиза	French
експлуатація	French
екстаз	French
екіпаж	French
елегантний	French
ембріон	French
енциклопедія	French
епопея	French
епізод	French
есе	French
етап	French
етикет	French
етикетаж	French
ешафот	French
ешелон	French
жандар	French
жандарм	French
Жанна	French
жанр	French
жаргон	French
желатин	French
желе	French
жест	French
жонглер	French
журналістика	French
зал	French
зебра	French
йод	French
кабіна	French
кавалерія	French
казуїстика	French
калорія	French
кальмар	French
калібр	French
камуфляж	French
каналізація	French
карт-бланш	French
картон	French
касета	French
каталог	French
категоричний	French
категорія	French
кашне	French
клімат	French
код	French
колабораціонізм	French
колаж	French
командир	French
комбінат	French
комфорт	French
конверт	French
конголезький	French
консервація	French
констатувати	French
консьєрж	French
контакт	French
контекст	French
контраст	French
коньяк	French
коректив	French
коридор	French
кортеж	French
косметика	French
космополітизм	French
котлета	French
кошмар	French
креветка	French
крем	French
крем-брюле	French
критик	French
критика	French
круасан	French
кузен	French
кузина	French
куліса	French
купол	French
купюра	French
кіоск	French
лексикограф	French
лексикографія	French
ложа	French
лояльний	French
люстра	French
лібералізм	French
лікер	French
лімузин	French
лінгвіст	French
лінгвістика	French
магнетизм	French
маз	French
макет	French
мандат	French
маневр	French
манера	French
манікюр	French
маніпуляція	French
маніфест	French
маніяк	French
Мар'яна	French
маркіз	French
мародер	French
масаж	French
масивний	French
маска	French
меблі	French
медикамент	French
медіум	French
меню	French
меса	French
метро	French
метрополітен	French
моветон	French
модель	French
модернізація	French
модифікація	French
модуль	French
модулювати	French
молекула	French
монолог	French
монтаж	French
мотив	French
мотоцикл	French
мусон	French
мігрень	French
мізантроп	French
мікроб	French
мікроскоп	French
мільйонер	French
мільярдер	French
мілітарист	French
мім	French
міна	French
мінерал	French
міріада	French
місіонер	French
Намюр	French
наркоз	French
наївний	French
негативний	French
неологізм	French
нюанс	French
нівелювати	French
обеліск	French
одеколон	French
Олланд	French
олів'є	French
омлет	French
оптимізм	French
оранжерея	French
організація	French
ореол	French
оркестр	French
павільйон	French
пальто	French
панацея	French
пандус	French
панно	French
пантеон	French
парадокс	French
паразит	French
паралель	French
парашут	French
парламент	French
партизан	French
парфум	French
паскаль	French
пасьянс	French
патруль	French
патріот	French
патріотизм	French
патуа	French
пацифізм	French
педант	French
пейзаж	French
периферія	French
персонаж	French
песимізм	French
пляж	French
поліклініка	French
політеїзм	French
політеїст	French
понтон	French
порнограф	French
портфель	French
пост	French
преамбула	French
прем'єр	French
прем'єра	French
престиж	French
прогноз	French
прокурор	French
пролог	French
профанація	French
профіль	French
процедура	French
псевдонім	French
психіатр	French
публіцист	French
публіцистика	French
пудра	French
пульс	French
пюпітр	French
пік	French
пікнік	French
пілот	French
пілотаж	French
пірат	French
пістолет	French
радикалізм	French
реванш	French
реваншизм	French
реваншист	French
револьвер	French
революціонер	French
редактор	French
режим	French
резерв	French
резервуар	French
резолюція	French
резонанс	French
резюме	French
рельєф	French
Ренесанс	French
реноме	French
репертуар	French
репортаж	French
репутація	French
рикошет	French
ритм	French
розетка	French
рокфор	French
романтизм	French
рулон	French
рутина	French
саботаж	French
садизм	French
садист	French
саксофон	French
салат	French
салон	French
сапер	French
сателіт	French
сезон	French
семестр	French
сержант	French
сертифікат	French
сигарета	French
сидр	French
символізм	French
синдром	French
сироп	French
ситро	French
скарлатина	French
софізм	French
соціалізм	French
соціаліст	French
спектр	French
спонтанний	French
спіраль	French
статика	French
стеарин	French
стенограма	French
суп	French
сутенер	French
суфлер	French
сюжет	French
сюрприз	French
сюїта	French
табло	French
талант	French
татуювати	French
тембр	French
терикон	French
термометр	French
терорист	French
тир	French
тоголезький	French
транспарант	French
трибуна	French
трибунал	French
трикотаж	French
тротуар	French
трупа	French
Трюдо	French
трюк	French
турбіна	French
туризм	French
турне	French
турнікет	French
тюль	French
тюльпан	French
тюрбан	French
увертюра	French
ураган	French
урбанізм	French
фантасмагорія	French
фантастика	French
фарш	French
фасад	French
ферма	French
фетиш	French
фетр	French
фея	French
флакон	French
фойє	French
фонд	French
форс-мажор	French
фотель	French
фоє	French
фриз	French
фронт	French
фуа-гра	French
фунікулер	French
фюзеляж	French
фігурант	French
філе	French
фінанси	French
фіньшампань	French
хронометраж	French
шампіньйон	French
шантаж	French
шато	French
шеврон	French
шедевр	French
шезлонг	French
шеф	French
шовінізм	French
шовініст	French
шок	French
шосе	French
шофер	French
ігрек	French
ідеал	French
ідентичний	French
ідеологія	French
імпресіонізм	French
імпровізація	French
інвалід	French
інтелект	French
інтенсифікація	French
інтер'єр	French
інтимний	French
інфінітив	French
інцидент	French
істерика	French
істерія	French
абвер	German
абзац	German
абітурієнт	German
агітація	German
адвокат	German
адмірал	German
адреса	German
адресат	German
айсберг	German
айстра	German
аквамарин	German
акцепт	German
альманах	German
амбулаторія	German
ампутація	German
аншлаг	German
апарат	German
археологія	German
архів	German
атестувати	German
атлет	German
аутизм	German
афоризм	German
базис	German
бак	German
бальзам	German
балістика	German
балія	German
банк	German
банкір	German
баркас	German
бас	German
бетон	German
бленда	German
блок	German
блокада	German
бліцкриг	German
бойкот	German
бор	German
бордель	German
борт	German
ботаніка	German
бригадир	German
бричка	German
брухт	German
бунт	German
бутерброд	German
бухгалтер	German
бухта	German
бюргер	German
бюрократія	German
бюстгальтер	German
вампір	German
вафля	German
вермут	German
вольфрам	German
волюнтаризм	German
вібрувати	German
візерунок	German
галстук	German
Гамбург	German
гарант	German
гарнізон	German
гауляйтер	German
гель	German
ген	German
гендель	German
генерал	German
генералітет	German
геном	German
геній	German
геологія	German
герцог	German
герцогиня	German
глазур	German
глінтвейн	German
гліцерин	German
горн	German
граніт	German
граф	German
графік	German
графіка	German
гросмайстер	German
гросмейстер	German
груба	German
гідравліка	German
гіпс	German
гієна	German
девальвація	German
дельфін	German
дизель	German
дилетант	German
дисфункція	German
доцент	German
драматург	German
друк	German
дюна	German
егіда	German
екватор	German
ензим	German
ентропія	German
епос	German
еротика	German
естетика	German
зал	German
залп	German
йод	German
кабель	German
казуїстика	German
канцлер	German
карат	German
картон	German
картоплина	German
картопля	German
категоричний	German
категорія	German
катетер	German
квартал	German
кварц	German
кельнер	German
Кенігсберг	German
клапан	German
клініка	German
клієнт	German
кнопка	German
колапс	German
комбінат	German
комфорт	German
конспект	German
контакт	German
контракт	German
концерн	German
кран	German
крах	German
крематорій	German
кронпринц	German
кронштейн	German
культура	German
купол	German
курорт	German
кіоск	German
кірха	German
кітч	German
лагер	German
лакриця	German
ландшафт	German
лен	German
лозунг	German
льох	German
лінза	German
мазохізм	German
майстер	German
макулатура	German
марганець	German
маршрут	German
маска	German
масштаб	German
матрац	German
матриця	German
машинґвер	German
медіум	German
менталітет	German
моль	German
монумент	German
морфологія	German
мотор	German
музика	German
мундштук	German
муніципалітет	German
мушля	German
Мюллер	German
міліціонер	German
міна	German
мінерал	German
нацизм	German
нейтралітет	German
номер	German
нострифікація	German
нікель	German
обеліск	German
опонент	German
Оппенгеймер	German
оригінальний	German
остарбайтер	German
павіан	German
пакувати	German
паніка	German
параметр	German
партія	German
пасажир	German
пасквіль	German
патент	German
патрон	German
пауза	German
пенал	German
плакат	German
планктон	German
плюш	German
пляцок	German
поза	German
поліклініка	German
полімер	German
полірувати	German
поліцай	German
портрет	German
препарат	German
преса	German
примат	German
принц	German
проба	German
провіант	German
провізія	German
продуктивний	German
проект	German
проєкт	German
псилоцибін	German
психіатр	German
психіатрія	German
пульт	German
пунш	German
путчист	German
пікнік	German
ранг	German
раритет	German
регулювати	German
резидент	German
рейс	German
рейтузи	German
респект	German
реферат	German
розбрат	German
рюкзак	German
Сансусі	German
семантика	German
семіт	German
серія	German
скандал	German
смарагд	German
спис	German
спонтанний	German
стамеска	German
статика	German
стелаж	German
стратег	German
суб'єкт	German
термін	German
термінологія	German
техніка	German
торт	German
торф	German
трактат	German
траса	German
тремпель	German
туберкульоз	German
турнір	German
туш	German
університет	German
файний	German
файно	German
факел	German
фальш	German
фамілія	German
фанера	German
фантаст	German
фарба	German
фах	German
фашина	German
фельдмаршал	German
фенхель	German
фермер	German
флігель	German
фокус	German
форпост	German
Франц	German
фрахт	German
футляр	German
фільварок	German
хвіртка	German
хірург	German
хірургія	German
цемент	German
циліндр	German
цинк	German
циферблат	German
цугцванг	German
шаблон	German
шакал	German
шарнір	German
швейцар	German
шина	German
шинка	German
шлагбаум	German
шланг	German
Шотландія	German
шпальта	German
шпинат	German
шприц	German
Шредер	German
шрифт	German
штаб	German
штандарт	German
штат	German
штраф	German
ювелір	German
Юнґ	German
єнот	German
ідеал	German
імпульс	German
імунітет	German
інвалід	German
інженер	German
інкасо	German
інстинкт	German
інформувати	German
інфінітив	German
ґаблі	German
ґешефт	German
абревіатура	Italian
аварія	Italian
альт	Italian
альтанка	Italian
атестат	Italian
банда	Italian
бандит	Italian
бас	Italian
баста	Italian
бричка	Italian
брутто	Italian
валюта	Italian
Венеція	Italian
вермішель	Italian
віолончель	Italian
гвардія	Italian
графіті	Italian
доміно	Italian
казино	Italian
капучино	Italian
кар'єра	Italian
карат	Italian
каса	Italian
кода	Italian
консерваторія	Italian
контрабас	Italian
концерт	Italian
крепатура	Italian
лава	Italian
лазанья	Italian
лоджія	Italian
маестро	Italian
макарони	Italian
малярія	Italian
мандоліна	Italian
маскарпоне	Italian
моцарела	Italian
новела	Italian
нунціатура	Italian
опера	Italian
папараці	Italian
помідор	Italian
піаніно	Italian
піца	Italian
піцерія	Italian
салямі	Italian
скарлатина	Italian
сонет	Italian
сорго	Italian
софіт	Italian
спагеті	Italian
студія	Italian
тариф	Italian
темп	Italian
тирамісу	Italian
тромбон	Italian
фашизм	Italian
фашист	Italian
флейта	Italian
фортепіано	Italian
фінал	Italian
інкасо	Italian
іредентизм	Italian
авгур	Latin
авдієнція	Latin
адендум	Latin
адепт	Latin
акузатив	Latin
акумуляція	Latin
алтей	Latin
аматор	Latin
амніоти	Latin
анамнії	Latin
анексія	Latin
антиномія	Latin
Антін	Latin
анулювати	Latin
анус	Latin
анігіляція	Latin
апатія	Latin
апеляція	Latin
апетит	Latin
апробація	Latin
аргумент	Latin
арена	Latin
арматура	Latin
асигнація	Latin
асигнувати	Latin
аспект	Latin
аспірація	Latin
Ассирія	Latin
астроном	Latin
атестат	Latin
атестація	Latin
атрибут	Latin
аудієнція	Latin
аура	Latin
база	Latin
баніція	Latin
бас	Latin
бонус	Latin
вагіна	Latin
вакуум	Latin
вакханалія	Latin
вокатив	Latin
вотум	Latin
вохра	Latin
вульва	Latin
генітив	Latin
гладіатор	Latin
глобус	Latin
гонор	Latin
градус	Latin
граматика	Latin
Дарій	Latin
датив	Latin
де-юре	Latin
дегенерат	Latin
декорум	Latin
декрет	Latin
делегація	Latin
демонстрація	Latin
денар	Latin
депутат	Latin
дефініція	Latin
диктатор	Latin
дикція	Latin
динозавр	Latin
дисертація	Latin
дисципліна	Latin
Дмитро	Latin
доктор	Latin
доктрина	Latin
діагональ	Latin
Дідона	Latin
дієта	Latin
екзема	Latin
екземпляр	Latin
економія	Latin
експозиція	Latin
експонат	Latin
екстракт	Latin
епос	Latin
ерекція	Latin
етика	Latin
етимологія	Latin
ефект	Latin
еякуляція	Latin
календар	Latin
камера	Latin
Каміла	Latin
канал	Latin
капсула	Latin
катакомба	Latin
катастрофа	Latin
катедра	Latin
катетер	Latin
квота	Latin
когорта	Latin
колегіум	Latin
колекція	Latin
колонія	Latin
колос	Latin
колумбарій	Latin
колізія	Latin
колір	Latin
кома	Latin
комета	Latin
комора	Latin
компонент	Latin
комунікація	Latin
контузія	Latin
конус	Latin
Конфуцій	Latin
копія	Latin
корпус	Latin
корупція	Latin
котинги	Latin
коїтус	Latin
кредитор	Latin
крепатура	Latin
кримінальний	Latin
кунілінгус	Latin
лавр	Latin
латинь	Latin
локатив	Latin
люстрація	Latin
літера	Latin
майор	Latin
Максим	Latin
медитація	Latin
меморандум	Latin
мигдаль	Latin
муза	Latin
мул	Latin
нація	Latin
номінатив	Latin
нотаріус	Latin
нунцій	Latin
окупація	Latin
опій	Latin
опіум	Latin
палій	Latin
пацифікація	Latin
пацієнт	Latin
пектораль	Latin
пеніс	Latin
плацебо	Latin
подіум	Latin
позитивний	Latin
предикат	Latin
президія	Latin
премія	Latin
провокатор	Latin
пропаганда	Latin
пропорція	Latin
професія	Latin
процесія	Latin
проєкт	Latin
пілюля	Latin
радіація	Latin
радіус	Latin
раціональний	Latin
резина	Latin
ремісія	Latin
Ренат	Latin
Рената	Latin
репресія	Latin
республіка	Latin
руїна	Latin
саламандра	Latin
сатира	Latin
сатрап	Latin
сегрегація	Latin
сенатор	Latin
Скандинавія	Latin
скульптор	Latin
скульптура	Latin
статут	Latin
сума	Latin
сцена	Latin
температура	Latin
теологія	Latin
територія	Latin
тріумф	Latin
Тюрингія	Latin
університет	Latin
унітаз	Latin
фабула	Latin
фантазія	Latin
флуктуація	Latin
формула	Latin
форум	Latin
фрагмент	Latin
фрустрація	Latin
фундамент	Latin
фігура	Latin
фізика	Latin
фізіологія	Latin
фіскальний	Latin
хрестоматія	Latin
цензура	Latin
центр	Latin
центуріон	Latin
цикл	Latin
цифра	Latin
Юнона	Latin
юрисдикція	Latin
юриспруденція	Latin
юстиція	Latin
Юстиція	Latin
ідіот	Latin
ілюмінація	Latin
ілюстрація	Latin
іманентний	Latin
імператор	Latin
імпліцитний	Latin
інгредієнт	Latin
індивід	Latin
індивідуум	Latin
індик	Latin
індикація	Latin
інкорпорація	Latin
інструктор	Latin
інструктувати	Latin
інструментал	Latin
інтелігент	Latin
інтерпретатор	Latin
інфракція	Latin
інфінітив	Latin
ініціатор	Latin
іригація	Latin
апостол	Old Church Slavonic
архангел	Old Church Slavonic
благий	Old Church Slavonic
благоговійний	Old Church Slavonic
благоговіти	Old Church Slavonic
благодать	Old Church Slavonic
благодіяння	Old Church Slavonic
благополуччя	Old Church Slavonic
благословення	Old Church Slavonic
благословити	Old Church Slavonic
благостиня	Old Church Slavonic
блаженство	Old Church Slavonic
божество	Old Church Slavonic
вериги	Old Church Slavonic
виноград	Old Church Slavonic
владика	Old Church Slavonic
власть	Old Church Slavonic
вождь	Old Church Slavonic
волхв	Old Church Slavonic
воскресати	Old Church Slavonic
воскресити	Old Church Slavonic
воскреснути	Old Church Slavonic
воскрешати	Old Church Slavonic
враг	Old Church Slavonic
врем'я	Old Church Slavonic
вівтар	Old Church Slavonic
віщати	Old Church Slavonic
глагол	Old Church Slavonic
говіти	Old Church Slavonic
Господь	Old Church Slavonic
грясти	Old Church Slavonic
догма	Old Church Slavonic
елефант	Old Church Slavonic
жертва	Old Church Slavonic
житіє	Old Church Slavonic
заточити	Old Church Slavonic
злато	Old Church Slavonic
капище	Old Church Slavonic
Лаврентій	Old Church Slavonic
лицемір	Old Church Slavonic
многая літа	Old Church Slavonic
мощі	Old Church Slavonic
насущний	Old Church Slavonic
начальник	Old Church Slavonic
невіглас	Old Church Slavonic
Никифор	Old Church Slavonic
нужда	Old Church Slavonic
область	Old Church Slavonic
овощ	Old Church Slavonic
олтар	Old Church Slavonic
омовіння	Old Church Slavonic
плачевний	Old Church Slavonic
поборник	Old Church Slavonic
подвиг	Old Church Slavonic
православний	Old Church Slavonic
правосуддя	Old Church Slavonic
прапор	Old Church Slavonic
предок	Old Church Slavonic
представляти	Old Church Slavonic
преподобний	Old Church Slavonic
престол	Old Church Slavonic
пролог	Old Church Slavonic
пророк	Old Church Slavonic
піп	Old Church Slavonic
раб	Old Church Slavonic
раба	Old Church Slavonic
священний	Old Church Slavonic
серафим	Old Church Slavonic
синагога	Old Church Slavonic
скверна	Old Church Slavonic
собор	Old Church Slavonic
совість	Old Church Slavonic
спаситель	Old Church Slavonic
страж	Old Church Slavonic
судилище	Old Church Slavonic
Сусанна	Old Church Slavonic
сущий	Old Church Slavonic
треба	Old Church Slavonic
уповати	Old Church Slavonic
храм	Old Church Slavonic
хранитель	Old Church Slavonic
Христос раждается	Old Church Slavonic
Христос рождається	Old Church Slavonic
член	Old Church Slavonic
юний	Old Church Slavonic
Єлизавета	Old Church Slavonic
єпархія	Old Church Slavonic
єр	Old Church Slavonic
Єрусалим	Old Church Slavonic
єрь	Old Church Slavonic
ігумен	Old Church Slavonic
ікона	Old Church Slavonic
Іларіон	Old Church Slavonic
істина	Old Church Slavonic
айва	Turkish
бакалія	Turkish
башмак	Turkish
бора	Turkish
гайда	Turkish
гяур	Turkish
емір	Turkish
зурна	Turkish
кава	Turkish
кантар	Turkish
килим	Turkish
лелека	Turkish
москаль	Turkish
око	Turkish
падишах	Turkish
паланка	Turkish
парча	Turkish
ревінь	Turkish
сердюк	Turkish
торба	Turkish
фарфор	Turkish
хурма	Turkish
чічка	Turkish
шапран	Turkish
шафран	Turkish
яничар	Turkish
інжир	Turkish
абрикоса	Polish
авторитет	Polish
агонія	Polish
адміністрація	Polish
актуальний	Polish
акуратний	Polish
альт	Polish
альтанка	Polish
аптека	Polish
арешт	Polish
аркуш	Polish
багнет	Polish
балія	Polish
бандура	Polish
банкрут	Polish
барва	Polish
бардзо	Polish
барило	Polish
башта	Polish
безпечний	Polish
бенкет	Polish
бидло	Polish
благати	Polish
блакитний	Polish
блакить	Polish
бленда	Polish
блюза	Polish
блякнути	Polish
бляха	Polish
бляшанка	Polish
борг	Polish
брак	Polish
бракувати	Polish
брама	Polish
братерство	Polish
братерський	Polish
бричка	Polish
бруд	Polish
брудний	Polish
брук	Polish
будинок	Polish
будувати	Polish
бульба	Polish
бунт	Polish
бурнус	Polish
бурштин	Polish
бутель	Polish
біскуп	Polish
вага	Polish
вагання	Polish
вагатися	Polish
вакації	Polish
валіза	Polish
вар'ят	Polish
варто	Polish
вважати	Polish
вежа	Polish
вельми	Polish
вензель	Polish
вербувати	Polish
вживати	Polish
вжити	Polish
вибачати	Polish
вибачити	Polish
вигляд	Polish
виглядати	Polish
виз	Polish
визначати	Polish
визначити	Polish
виконати	Polish
виконувати	Polish
використати	Polish
використовувати	Polish
випродукувати	Polish
вирок	Polish
витлумачити	Polish
виховати	Polish
виховувати	Polish
власний	Polish
волати	Polish
вохра	Polish
вправа	Polish
вправний	Polish
Вроцлав	Polish
втілити	Polish
відвага	Polish
відвертий	Polish
відпочивати	Polish
відчувати	Polish
відчути	Polish
візерунок	Polish
війт	Polish
вітати	Polish
газард	Polish
ганьба	Polish
гармата	Polish
гасло	Polish
гаубиця	Polish
гвардія	Polish
гвинт	Polish
гвинтівка	Polish
гербата	Polish
Гишпанія	Polish
готівка	Polish
грош	Polish
гріш	Polish
губернатор	Polish
гумор	Polish
гумореска	Polish
гурт	Polish
гусар	Polish
даремний	Polish
дах	Polish
делегат	Polish
дзьоб	Polish
дзьобати	Polish
докладний	Polish
дотик	Polish
друкувати	Polish
друшляк	Polish
дріт	Polish
дупа	Polish
евакуювати	Polish
есей	Polish
жарт	Polish
жвавий	Polish
жебрак	Polish
жовнір	Polish
жодний	Polish
завжди	Polish
завзятий	Polish
завше	Polish
заздрісний	Polish
залицятися	Polish
замок	Polish
запальничка	Polish
затока	Polish
зброя	Polish
збруя	Polish
Звягель	Polish
здання	Polish
злотий	Polish
знівечити	Polish
зрадити	Polish
зрозумілий	Polish
зухвалий	Polish
кав'ярня	Polish
казарма	Polish
каламар	Polish
канапа	Polish
каплиця	Polish
капітулювати	Polish
капітуляція	Polish
карта	Polish
касувати	Polish
кат	Polish
катедра	Polish
катувати	Polish
каштан	Polish
кваліфікація	Polish
квасоля	Polish
квиток	Polish
квітка	Polish
келех	Polish
келих	Polish
кепський	Polish
керувати	Polish
керівник	Polish
киянка	Polish
клавіатура	Polish
клавіша	Polish
кобіта	Polish
ковадло	Polish
ковдра	Polish
колежанка	Polish
коліжанка	Polish
коментувати	Polish
комплект	Polish
конвалія	Polish
конкуренція	Polish
конфіскувати	Polish
копати	Polish
копнути	Polish
кордон	Polish
коригувати	Polish
корок	Polish
корона	Polish
костьол	Polish
кошиківка	Polish
кошт	Polish
коштувати	Polish
коєць	Polish
коїти	Polish
краватка	Polish
краля	Polish
крапка	Polish
креслити	Polish
криж	Polish
крижмо	Polish
кришталь	Polish
крок	Polish
кролик	Polish
крохмаль	Polish
ксьондз	Polish
кульчик	Polish
куля	Polish
кунтуш	Polish
кухар	Polish
кухарка	Polish
куштувати	Polish
кшталт	Polish
кімната	Polish
лава	Polish
лавина	Polish
ланцюг	Polish
литка	Polish
лицар	Polish
льох	Polish
льоха	Polish
любисток	Polish
люстерко	Polish
люстро	Polish
лютня	Polish
лялька	Polish
лік	Polish
лічити	Polish
мальовничий	Polish
малювати	Polish
маляр	Polish
мапа	Polish
маргінес	Polish
мева	Polish
мета	Polish
милити	Polish
мобілізувати	Polish
можливий	Polish
можна	Polish
монархиня	Polish
морва	Polish
морг	Polish
мружити	Polish
музика	Polish
мур	Polish
мушкет	Polish
мушля	Polish
муштарда	Polish
муштра	Polish
місце	Polish
міцний	Polish
міць	Polish
міщанин	Polish
міщанство	Polish
на ніби	Polish
навзаєм	Polish
навігація	Polish
навіть	Polish
назавше	Polish
намалювати	Polish
намет	Polish
нарада	Polish
нарешті	Polish
натхнути	Polish
натще	Polish
нація	Polish
небезпечний	Polish
неборак	Polish
невимовний	Polish
недосконалий	Polish
нирка	Polish
нута	Polish
нівечити	Polish
нікчемний	Polish
обіцяти	Polish
огонек	Polish
оковита	Polish
окуляри	Polish
олівець	Polish
опінія	Polish
оренда	Polish
орнамент	Polish
освіта	Polish
отримати	Polish
отримувати	Polish
офіра	Polish
п'єц	Polish
пакунок	Polish
палац	Polish
панна	Polish
панове	Polish
панчоха	Polish
папір	Polish
парафія	Polish
паркан	Polish
пастернак	Polish
пательня	Polish
пашпорт	Polish
паштет	Polish
певний	Polish
пекельний	Polish
пензель	Polish
переконати	Polish
перший	Polish
петрушка	Polish
плаский	Polish
плюндрувати	Polish
пляма	Polish
пляцок	Polish
пляшка	Polish
подарунок	Polish
подобатися	Polish
покута	Polish
покутувати	Polish
полковник	Polish
поляк	Polish
політика	Polish
поліція	Polish
помаранчевий	Polish
пончик	Polish
порція	Polish
порічка	Polish
посполу	Polish
поцька	Polish
поцілунок	Polish
почастувати	Polish
пошта	Polish
прагнути	Polish
пранці	Polish
працьовитий	Polish
працювати	Polish
представити	Polish
претендент	Polish
претензія	Polish
приватний	Polish
приклад	Polish
принаймні	Polish
проба	Polish
пробачати	Polish
пробачити	Polish
провізія	Polish
продукувати	Polish
промінь	Polish
пропозиція	Polish
простирадло	Polish
прошу	Polish
публіка	Polish
пігулка	Polish
підлий	Polish
піднебіння	Polish
підручник	Polish
підступний	Polish
рама	Polish
раптом	Polish
рахувати	Polish
рахунок	Polish
рація	Polish
регіт	Polish
рекомендація	Polish
рекрут	Polish
ретельний	Polish
решта	Polish
риж	Polish
ринва	Polish
ринок	Polish
риса	Polish
ровер	Polish
родзинка	Polish
родзинки	Polish
рожевий	Polish
розбестити	Polish
розрахунок	Polish
ропуха	Polish
рятувати	Polish
Ряшів	Polish
Річ Посполита	Polish
сарна	Polish
свідомий	Polish
сейм	Polish
сесія	Polish
симпатія	Polish
скандувати	Polish
скарб	Polish
скарга	Polish
склеп	Polish
скроня	Polish
слюсар	Polish
смак	Polish
смаколик	Polish
смалець	Polish
смітник	Polish
спина	Polish
сподобатися	Polish
сподіватися	Polish
срібло	Polish
статечний	Polish
стельмах	Polish
стосунок	Polish
страйк	Polish
страшидло	Polish
сума	Polish
сумління	Polish
танець	Polish
танцювати	Polish
таємний	Polish
таємниця	Polish
теж	Polish
темперамент	Polish
тимчасовий	Polish
титул	Polish
тлумач	Polish
тлумачити	Polish
тлустий	Polish
трактувати	Polish
треба	Polish
трунок	Polish
трускавка	Polish
туз	Polish
турбувати	Polish
тістечко	Polish
увага	Polish
умова	Polish
універсал	Polish
урочистий	Polish
фабрика	Polish
файний	Polish
файно	Polish
фамілія	Polish
фах	Polish
ферії	Polish
фольга	Polish
фортеця	Polish
Франція	Polish
фільварок	Polish
філіжанка	Polish
фіолетовий	Polish
фіґель	Polish
хвацький	Polish
хвилина	Polish
хвиля	Polish
хвиґура	Polish
хлопак	Polish
хлопець	Polish
хорунжий	Polish
хутро	Polish
цвинтар	Polish
цвях	Polish
цебер	Polish
цегла	Polish
цех	Polish
цидула	Polish
цимбали	Polish
цитадель	Polish
цитрина	Polish
цнота	Polish
цнотливий	Polish
цукор	Polish
цікавий	Polish
цілунок	Polish
ціль	Polish
частувати	Polish
чаїтися	Polish
чигати	Polish
членкиня	Polish
шабля	Polish
шалений	Polish
шанець	Polish
шановний	Polish
шанувати	Polish
шафар	Polish
шахи	Polish
шахрай	Polish
швагер	Polish
шваґер	Polish
шинок	Polish
шкарпетка	Polish
шкатулка	Polish
шквал	Polish
школяр	Polish
шкура	Polish
шлюб	Polish
шлях	Polish
шляхетний	Polish
шліфувати	Polish
шомпол	Polish
шпалера	Polish
шпиталь	Polish
шпіхлір	Polish
штука	Polish
шукати	Polish
шухляда	Polish
як ся маєш	Polish
ярмарок	Polish
євробляха	Polish
єдваб	Polish
імбир	Polish
інстанція	Polish
інструмент	Polish
інтелігенція	Polish
ґанок	Polish
ґара	Polish
ґатунок	Polish
ґацик	Polish
ґвалт	Polish
ґвара	Polish
ґедзь	Polish
ґніт	Polish
ґонт	Polish
ґоґель-моґель	Polish
ґрасувати	Polish
ґрати	Polish
ґречний	Polish
ґуральня	Polish
аврал	Russian
автомат	Russian
агент	Russian
азарт	Russian
акула	Russian
алхімія	Russian
амністія	Russian
антагонізм	Russian
апельсин	Russian
арка	Russian
Армянськ	Russian
артіль	Russian
асортимент	Russian
атмосфера	Russian
афаліна	Russian
бамбук	Russian
банка	Russian
барабан	Russian
барахло	Russian
блін	Russian
бокал	Russian
бомж	Russian
буквальний	Russian
буксир	Russian
буксирувати	Russian
бумага	Russian
біляш	Russian
біржа	Russian
біснуватий	Russian
Ванька	Russian
ватник	Russian
велосипед	Russian
вертоліт	Russian
взвод	Russian
вимпел	Russian
водка	Russian
вокзал	Russian
Волгін	Russian
всьо	Russian
вумний	Russian
вірнопідданий	Russian
вірьовка	Russian
гавань	Russian
галерея	Russian
галімий	Russian
гарпун	Russian
гастроль	Russian
градирня	Russian
грейпфрут	Russian
грохот	Russian
гусар	Russian
дамба	Russian
дача	Russian
декабрист	Russian
дембель	Russian
дефіцит	Russian
дистанція	Russian
екстрений	Russian
електрон	Russian
заняття	Russian
запивон	Russian
заточити	Russian
зачистка	Russian
зек	Russian
Калінінград	Russian
канонерка	Russian
канєшно	Russian
капітан	Russian
карамель	Russian
каструля	Russian
кафе	Russian
кент	Russian
кисет	Russian
ковролін	Russian
колектив	Russian
Колесник	Russian
колчан	Russian
комплімент	Russian
комунізм	Russian
комуніст	Russian
кондитер	Russian
контрабанда	Russian
контур	Russian
конфета	Russian
копійка	Russian
космогонія	Russian
косоворотка	Russian
кофе	Russian
крейсер	Russian
кувалда	Russian
кузов	Russian
курага	Russian
кібернетика	Russian
кілька	Russian
лаванда	Russian
лагер	Russian
ланцет	Russian
лапша	Russian
ларьок	Russian
лейтенант	Russian
люк	Russian
магазин	Russian
мамонт	Russian
мамут	Russian
Маріуполь	Russian
матрос	Russian
матрьошка	Russian
мент	Russian
ментовка	Russian
морг	Russian
мракобісся	Russian
мусор	Russian
навряд	Russian
натюрморт	Russian
нафта	Russian
Новоросійськ	Russian
Нікіта	Russian
обиватель	Russian
обойма	Russian
односельчанин	Russian
офігенний	Russian
Параша	Russian
паровоз	Russian
пельмень	Russian
пелядь	Russian
пиздіти	Russian
планктон	Russian
плато	Russian
плацдарм	Russian
плінтус	Russian
покупка	Russian
получка	Russian
посольство	Russian
продовольство	Russian
Путлер	Russian
Пхеньян	Russian
підарас	Russian
пінцет	Russian
редиска	Russian
резина	Russian
реквізит	Russian
рекрут	Russian
розвальні	Russian
рупор	Russian
русоріз	Russian
рябчик	Russian
самокат	Russian
самшит	Russian
Санкт-Петербург	Russian
Світлана	Russian
скромний	Russian
смисл	Russian
снаряд	Russian
солдат	Russian
соус	Russian
Сочі	Russian
союз	Russian
спеція	Russian
спирт	Russian
стакан	Russian
стаття	Russian
страхувати	Russian
Сєвєродонецьк	Russian
сільпо	Russian
труси	Russian
тьолка	Russian
тьотя	Russian
тюлень	Russian
ублюдок	Russian
устриця	Russian
феєрверк	Russian
флагман	Russian
флагшток	Russian
фрейліна	Russian
фритюр	Russian
чага	Russian
чекіст	Russian
чувак	Russian
шаньга	Russian
шар	Russian
шарманка	Russian
шеренга	Russian
шинель	Russian
шов	Russian
Єбларусь	Russian
інтелігенція	Russian
їбало	Russian